Precinct,Registered Voters,Election Day,Absentee,Provisional,Ballots Cast,Voter Turnout
Aleppo,1363,671,441,16,1128,82.76%
Aspinwall Dist 1,855,554,167,9,730,85.38%
Aspinwall Dist 2,582,346,117,9,472,81.10%
Aspinwall Dist 3,827,507,179,12,698,84.40%
Avalon Ward 1,1115,616,211,22,849,76.14%
Avalon Ward 2 Dist 1,712,406,138,10,554,77.81%
Avalon Ward 2 Dist 2,472,242,118,9,369,78.18%
Avalon Ward 3 Dist 1,335,188,92,1,281,83.88%
Avalon Ward 3 Dist 2,459,215,135,6,356,77.56%
Avalon Ward 3 Dist 3,517,243,129,5,377,72.92%
Baldwin Br Dist 1,613,339,163,3,505,82.38%
Baldwin Br Dist 2,1041,575,305,1,881,84.63%
Baldwin Br Dist 3,857,517,189,7,713,83.20%
Baldwin Br Dist 4,798,474,188,9,671,84.09%
Baldwin Br Dist 5,840,484,195,11,690,82.14%
Baldwin Br Dist 6,743,411,195,10,616,82.91%
Baldwin Br Dist 7,833,479,220,6,705,84.63%
Baldwin Br Dist 8,729,415,211,5,631,86.56%
Baldwin Br Dist 9,776,412,212,12,636,81.96%
Baldwin Br Dist 10,1029,422,194,21,637,61.90%
Baldwin Br Dist 11,1308,525,265,36,826,63.15%
Baldwin Br Dist 12,660,408,153,4,565,85.61%
Baldwin Br Dist 13,685,446,153,6,605,88.32%
Baldwin Br Dist 14,614,372,142,6,520,84.69%
Baldwin Br Dist 15,806,481,218,6,705,87.47%
Baldwin Br Dist 16,916,532,204,5,741,80.90%
Baldwin Br Dist 17,678,365,189,10,564,83.19%
Baldwin Br Dist 18,972,530,276,14,820,84.36%
Baldwin Tp Dist 1,809,522,172,2,696,86.03%
Baldwin Tp Dist 2,762,466,154,5,625,82.02%
Bell Acres,1188,690,297,4,991,83.42%
Bellevue Ward 1 Dist 1,973,483,222,12,717,73.69%
Bellevue Ward 1 Dist 2,984,526,207,10,743,75.51%
Bellevue Ward 2 Dist 1,1092,560,215,13,788,72.16%
Bellevue Ward 2 Dist 2,989,519,204,15,738,74.62%
Bellevue Ward 3 Dist 1,1048,547,229,10,786,75.00%
Bellevue Ward 3 Dist 2,981,544,201,16,761,77.57%
Ben Avon Dist 1,496,321,107,0,428,86.29%
Ben Avon Dist 2,994,613,221,7,841,84.61%
Ben Avon Ht,341,208,89,1,298,87.39%
Bethel Park Ward 1 Dist 1,869,459,256,4,719,82.74%
Bethel Park Ward 1 Dist 2,801,451,217,4,672,83.90%
Bethel Park Ward 1 Dist 3,840,469,232,6,707,84.17%
Bethel Park Ward 2 Dist 1,748,450,185,1,636,85.03%
Bethel Park Ward 2 Dist 2,939,520,275,13,808,86.05%
Bethel Park Ward 2 Dist 3,1099,604,332,4,940,85.53%
Bethel Park Ward 3 Dist 1,791,464,216,6,686,86.73%
Bethel Park Ward 3 Dist 2,1100,582,369,10,961,87.36%
Bethel Park Ward 3 Dist 3,1055,589,327,10,926,87.77%
Bethel Park Ward 4 Dist 1,1351,745,415,10,1170,86.60%
Bethel Park Ward 4 Dist 2,808,418,258,11,687,85.02%
Bethel Park Ward 4 Dist 3,878,461,258,8,727,82.80%
Bethel Park Ward 5 Dist 1,712,393,194,3,590,82.87%
Bethel Park Ward 5 Dist 2,653,387,145,5,537,82.24%
Bethel Park Ward 5 Dist 3,1481,646,535,8,1189,80.28%
Bethel Park Ward 6 Dist 1,1285,711,383,8,1102,85.76%
Bethel Park Ward 6 Dist 2,945,545,271,5,821,86.88%
Bethel Park Ward 6 Dist 3,908,471,273,9,753,82.93%
Bethel Park Ward 7 Dist 1,1182,684,329,10,1023,86.55%
Bethel Park Ward 7 Dist 2,1286,624,400,11,1035,80.48%
Bethel Park Ward 7 Dist 3,760,413,232,4,649,85.39%
Bethel Park Ward 8 Dist 1,556,321,149,0,470,84.53%
Bethel Park Ward 8 Dist 2,526,223,166,5,394,74.90%
Bethel Park Ward 8 Dist 3,1322,742,388,4,1134,85.78%
Bethel Park Ward 8 Dist 4,468,267,132,5,404,86.32%
Bethel Park Ward 9 Dist 1,594,365,140,8,513,86.36%
Bethel Park Ward 9 Dist 2,750,422,188,4,614,81.87%
Bethel Park Ward 9 Dist 3,1398,740,443,8,1191,85.19%
Blawnox,1010,549,225,17,791,78.32%
Brackenridge Ward 1,481,266,60,5,331,68.81%
Brackenridge Ward 2,800,469,161,3,633,79.13%
Brackenridge Ward 3,683,382,97,5,484,70.86%
Braddock Ward 1,440,168,58,15,241,54.77%
Braddock Ward 2,607,256,89,10,355,58.48%
Braddock Ward 3,461,176,41,3,220,47.72%
Braddock Hl Dist 1,798,343,178,11,532,66.67%
Braddock Hl Dist 2,525,312,118,9,439,83.62%
Bradford Woods,1021,564,303,6,873,85.50%
Brentwood Dist 1,547,342,110,3,455,83.18%
Brentwood Dist 2,767,411,156,7,574,74.84%
Brentwood Dist 3,650,393,114,2,509,78.31%
Brentwood Dist 4,806,436,188,13,637,79.03%
Brentwood Dist 5,735,378,117,11,506,68.84%
Brentwood Dist 6,672,313,148,17,478,71.13%
Brentwood Dist 7,772,397,169,12,578,74.87%
Brentwood Dist 8,728,402,189,7,598,82.14%
Brentwood Dist 9,600,331,160,5,496,82.67%
Brentwood Dist 10,565,330,111,5,446,78.94%
Bridgeville Dist 1,792,463,135,14,612,77.27%
Bridgeville Dist 2,875,527,151,10,688,78.63%
Bridgeville Dist 3,850,512,164,9,685,80.59%
Bridgeville Dist 4,1008,556,247,10,813,80.65%
Carnegie Ward 1 Dist 1,548,307,94,14,415,75.73%
Carnegie Ward 1 Dist 2,1218,691,219,22,932,76.52%
Carnegie Ward 1 Dist 3,871,519,159,9,687,78.87%
Carnegie Ward 1 Dist 4,373,153,85,7,245,65.68%
Carnegie Ward 2 Dist 1,667,350,116,19,485,72.71%
Carnegie Ward 2 Dist 2,514,281,113,8,402,78.21%
Carnegie Ward 2 Dist 3,494,268,146,3,417,84.41%
Carnegie Ward 2 Dist 4,836,393,159,11,563,67.34%
Casl Shannon Dist 1,1069,502,260,17,779,72.87%
Casl Shannon Dist 2,799,468,145,9,622,77.85%
Casl Shannon Dist 3,872,493,200,9,702,80.50%
Casl Shannon Dist 4,655,340,178,5,523,79.85%
Casl Shannon Dist 5,842,463,183,8,654,77.67%
Casl Shannon Dist 6,653,362,179,6,547,83.77%
Casl Shannon Dist 7,744,427,186,11,624,83.87%
Casl Shannon Dist 8,551,308,129,4,441,80.04%
Chalfant Dist 1,606,331,123,7,461,76.07%
Cheswick Dist 1,661,411,147,7,565,85.48%
Cheswick Dist 2,652,408,162,5,575,88.19%
Churchill Dist 1,717,385,224,2,611,85.22%
Churchill Dist 2,701,362,224,2,588,83.88%
Churchill Dist 3,650,366,201,4,571,87.85%
Churchill Dist 4,701,372,215,3,590,84.17%
Clairton Ward 1 Dist 1,361,165,42,6,213,59.00%
Clairton Ward 1 Dist 2,429,213,65,4,282,65.73%
Clairton Ward 1 Dist 3,338,196,36,5,237,70.12%
Clairton Ward 2 Dist 1,94,48,6,1,55,58.51%
Clairton Ward 2 Dist 2,281,116,42,7,165,58.72%
Clairton Ward 2 Dist 3,421,167,68,3,238,56.53%
Clairton Ward 3 Dist 1,448,213,85,6,304,67.86%
Clairton Ward 3 Dist 2,318,134,65,3,202,63.52%
Clairton Ward 3 Dist 3,350,128,55,9,192,54.86%
Clairton Ward 4 Dist 1,347,171,40,0,211,60.81%
Clairton Ward 4 Dist 2,377,165,46,8,219,58.09%
Clairton Ward 4 Dist 3,421,221,72,4,297,70.55%
Collier Dist 1,1662,958,447,22,1427,85.86%
Collier Dist 2,1416,882,320,11,1213,85.66%
Collier Dist 3,1309,674,407,9,1090,83.27%
Collier Dist 4,762,439,191,3,633,83.07%
Collier Dist 5,1005,509,306,12,827,82.29%
Collier Dist 6,1154,625,275,11,911,78.94%
Coraopolis Ward 1 Dist 1,456,249,79,4,332,72.81%
Coraopolis Ward 1 Dist 2,481,279,81,7,367,76.30%
Coraopolis Ward 2,813,360,185,10,555,68.27%
Coraopolis Ward 3 Dist 1,593,312,136,6,454,76.56%
Coraopolis Ward 3 Dist 2,557,317,119,12,448,80.43%
Coraopolis Ward 4 Dist 1,457,253,83,7,343,75.05%
Coraopolis Ward 4 Dist 2,523,289,112,7,408,78.01%
Crafton Ward 1 Dist 1,905,495,212,6,713,78.78%
Crafton Ward 1 Dist 2,598,334,125,9,468,78.26%
Crafton Ward 2 Dist 1,608,354,131,1,486,79.93%
Crafton Ward 2 Dist 2,786,379,194,5,578,73.54%
Crafton Ward 3 Dist 1,1005,584,216,10,810,80.60%
Crafton Ward 3 Dist 2,563,351,97,6,454,80.64%
Crescent Ward 1,1078,658,219,9,886,82.19%
Crescent Ward 2,698,429,132,2,563,80.66%
Dormont Dist 1,729,379,182,0,561,76.95%
Dormont Dist 2,546,350,125,1,476,87.18%
Dormont Dist 3,927,528,191,7,726,78.32%
Dormont Dist 4,662,342,168,3,513,77.49%
Dormont Dist 5,1026,560,233,18,811,79.04%
Dormont Dist 6,519,281,137,9,427,82.27%
Dormont Dist 7,521,294,129,2,425,81.57%
Dormont Dist 8,407,246,88,2,336,82.56%
Dormont Dist 9,544,315,125,4,444,81.62%
Dormont Dist 10,636,409,110,8,527,82.86%
Dravosburg Dist 1,540,289,95,3,387,71.67%
Dravosburg Dist 2,341,204,75,0,279,81.82%
Dravosburg Dist 3,257,153,55,2,210,81.71%
Duquesne Ward 1 Dist 1,449,231,78,11,320,71.27%
Duquesne Ward 1 Dist 2,485,175,77,16,268,55.26%
Duquesne Ward 1 Dist 3,296,111,26,5,142,47.97%
Duquesne Ward 1 Dist 4,192,69,23,6,98,51.04%
Duquesne Ward 2 Dist 1,328,115,47,4,166,50.61%
Duquesne Ward 2 Dist 2,362,137,45,9,191,52.76%
Duquesne Ward 2 Dist 3,426,187,61,8,256,60.09%
Duquesne Ward 3 Dist 1,224,86,30,8,124,55.36%
Duquesne Ward 3 Dist 2,146,54,19,4,77,52.74%
Duquesne Ward 3 Dist 3,528,236,79,5,320,60.61%
East Deer Ward 1,349,231,50,2,283,81.09%
East Deer Ward 2,604,345,122,7,474,78.48%
E McKeesport Dist 1,400,226,74,6,306,76.50%
E McKeesport Dist 2,531,308,89,7,404,76.08%
E McKeesport Dist 3,474,268,80,4,352,74.26%
E Pittsburgh Ward 1,342,140,37,6,183,53.51%
E Pittsburgh Ward 2,387,165,48,5,218,56.33%
E Pittsburgh Ward 3,514,185,71,4,260,50.58%
Edgewood Dist 1,1074,527,324,14,865,80.54%
Edgewood Dist 2,938,484,297,6,787,83.90%
Edgewood Dist 3,882,402,314,13,729,82.65%
Edgeworth Dist 1,675,367,196,4,567,84.00%
Edgeworth Dist 2,801,434,210,3,647,80.77%
Elizabeth Br,894,548,129,9,686,76.73%
Elizabeth Tp Ward 1 Dist 1,565,367,108,2,477,84.42%
Elizabeth Tp Ward 1 Dist 2,969,628,189,8,825,85.14%
Elizabeth Tp Ward 2,1353,868,278,6,1152,85.14%
Elizabeth Tp Ward 3,1388,883,311,5,1199,86.38%
Elizabeth Tp Ward 4 Dist 1,883,520,198,8,726,82.22%
Elizabeth Tp Ward 4 Dist 2,435,280,102,3,385,88.51%
Elizabeth Tp Ward 5 Dist 1,439,278,59,3,340,77.45%
Elizabeth Tp Ward 5 Dist 2,790,474,145,8,627,79.37%
Elizabeth Tp Ward 6 Dist 1,610,411,109,8,528,86.56%
Elizabeth Tp Ward 6 Dist 2,751,475,140,5,620,82.56%
Elizabeth Tp Ward 7,1231,788,253,6,1047,85.05%
Emsworth Dist 1,795,464,166,4,634,79.75%
Emsworth Dist 2,1006,560,211,7,778,77.34%
Etna Ward 1,828,493,132,7,632,76.33%
Etna Ward 2,688,338,140,10,488,70.93%
Etna Ward 3,714,443,118,6,567,79.41%
Fawn Dist 1,571,382,102,3,487,85.29%
Fawn Dist 2,948,604,189,7,800,84.39%
Findlay Dist 1,1800,1091,344,7,1442,80.11%
Findlay Dist 2,2053,1198,458,15,1671,81.39%
Findlay Dist 3,1293,820,279,7,1106,85.54%
Forest Hills Dist 1,626,352,196,2,550,87.86%
Forest Hills Dist 2,653,359,178,8,545,83.46%
Forest Hills Dist 3,643,349,176,11,536,83.36%
Forest Hills Dist 4,775,406,187,5,598,77.16%
Forest Hills Dist 5,710,422,178,4,604,85.07%
Forest Hills Dist 6,608,348,177,4,529,87.01%
Forest Hills Dist 7,773,395,124,8,527,68.18%
Forest Hills Dist 8,726,387,195,7,589,81.13%
Forward Dist 1,374,256,59,0,315,84.22%
Forward Dist 2,866,533,166,8,707,81.64%
Forward Dist 3,395,254,68,2,324,82.03%
Forward Dist 4,466,317,76,0,393,84.33%
Fox Chapel Dist 1,852,435,273,9,717,84.15%
Fox Chapel Dist 2,1020,512,320,5,837,82.06%
Fox Chapel Dist 3,752,388,239,5,632,84.04%
Fox Chapel Dist 4,1210,621,369,10,1000,82.64%
Fox Chapel Dist 5,963,455,307,8,770,79.96%
Franklin Pk Ward 1 Dist 1,1228,680,357,5,1042,84.85%
Franklin Pk Ward 1 Dist 2,1519,705,530,18,1253,82.49%
Franklin Pk Ward 1 Dist 3,1292,648,429,4,1081,83.67%
Franklin Pk Ward 2 Dist 1,1310,705,428,11,1144,87.33%
Franklin Pk Ward 2 Dist 2,1298,564,520,8,1092,84.13%
Franklin Pk Ward 2 Dist 3,1454,796,469,6,1271,87.41%
Franklin Pk Ward 3 Dist 1,1359,630,494,8,1132,83.30%
Franklin Pk Ward 3 Dist 2,778,454,220,3,677,87.02%
Franklin Pk Ward 3 Dist 3,1294,674,439,9,1122,86.71%
Frazer,826,568,153,5,726,87.89%
Glassport Dist 1,566,305,112,11,428,75.62%
Glassport Dist 2,409,182,39,11,232,56.72%
Glassport Dist 3,561,241,95,4,340,60.61%
Glassport Dist 4,260,131,28,0,159,61.15%
Glassport Dist 5,475,255,93,8,356,74.95%
Glassport Dist 6,438,235,72,10,317,72.37%
Glenfield,148,104,19,1,124,83.78%
Green Tree Dist 1,788,523,171,6,700,88.83%
Green Tree Dist 2,1066,664,261,6,931,87.34%
Green Tree Dist 3,1100,629,251,4,884,80.36%
Green Tree Dist 4,896,495,210,6,711,79.35%
Hampton Dist 1,1218,671,371,9,1051,86.29%
Hampton Dist 2,1302,740,355,5,1100,84.49%
Hampton Dist 3,1370,703,454,7,1164,84.96%
Hampton Dist 4,649,406,135,9,550,84.75%
Hampton Dist 5,707,398,196,9,603,85.29%
Hampton Dist 6,644,337,193,7,537,83.39%
Hampton Dist 7,1444,769,447,8,1224,84.76%
Hampton Dist 8,975,542,283,9,834,85.54%
Hampton Dist 9,1493,903,422,5,1330,89.08%
Hampton Dist 10,1604,829,498,10,1337,83.35%
Hampton Dist 11,1708,1011,474,12,1497,87.65%
Hampton Dist 12,898,536,232,6,774,86.19%
Hampton Dist 13,766,435,226,4,665,86.81%
Harmar Dist 1,1269,580,428,12,1020,80.38%
Harmar Dist 2,670,349,148,10,507,75.67%
Harmar Dist 3,360,218,76,4,298,82.78%
Harrison Ward 1 Dist 1,293,201,56,2,259,88.40%
Harrison Ward 1 Dist 2,603,348,166,4,518,85.90%
Harrison Ward 1 Dist 3,727,464,123,5,592,81.43%
Harrison Ward 2 Dist 1,362,222,69,4,295,81.49%
Harrison Ward 2 Dist 2,577,300,73,6,379,65.68%
Harrison Ward 3 Dist 1,1078,640,277,12,929,86.18%
Harrison Ward 3 Dist 2,649,430,130,4,564,86.90%
Harrison Ward 4 Dist 1,710,462,129,2,593,83.52%
Harrison Ward 4 Dist 2,616,365,120,3,488,79.22%
Harrison Ward 5 Dist 1,521,226,88,3,317,60.84%
Harrison Ward 5 Dist 2,829,528,146,4,678,81.79%
Haysville,60,42,14,1,57,95.00%
Heidelberg,917,570,135,11,716,78.08%
Homestead Ward 1 Dist 1,571,226,106,7,339,59.37%
Homestead Ward 1 Dist 2,345,151,48,5,204,59.13%
Homestead Ward 2 Dist 1,470,203,67,14,284,60.43%
Homestead Ward 2 Dist 2,278,141,34,2,177,63.67%
Homestead Ward 3 Dist 1,439,197,40,10,247,56.26%
Homestead Ward 3 Dist 2,261,118,30,1,149,57.09%
Indiana Dist 1,970,582,220,13,815,84.02%
Indiana Dist 2,871,510,217,11,738,84.73%
Indiana Dist 3,1598,909,390,6,1305,81.66%
Indiana Dist 4,1199,650,341,11,1002,83.57%
Indiana Dist 5,1000,558,283,14,855,85.50%
Ingram Dist 1,844,506,155,10,671,79.50%
Ingram Dist 2,626,367,115,3,485,77.48%
Ingram Dist 3,921,574,186,7,767,83.28%
Jefferson Hl Dist 1,1199,712,312,15,1039,86.66%
Jefferson Hl Dist 2,934,588,193,12,793,84.90%
Jefferson Hl Dist 3,1160,600,303,8,911,78.53%
Jefferson Hl Dist 4,968,519,248,6,773,79.86%
Jefferson Hl Dist 5,1191,649,360,12,1021,85.73%
Jefferson Hl Dist 6,820,568,131,1,700,85.37%
Jefferson Hl Dist 7,673,405,175,7,587,87.22%
Jefferson Hl Dist 8,1077,638,297,10,945,87.74%
Jefferson Hl Dist 9,1101,612,355,8,975,88.56%
Kennedy Dist 1,1500,898,404,8,1310,87.33%
Kennedy Dist 2,988,510,253,11,774,78.34%
Kennedy Dist 3,988,589,251,3,843,85.32%
Kennedy Dist 4,455,264,121,3,388,85.27%
Kennedy Dist 5,1439,899,336,11,1246,86.59%
Kennedy Dist 6,949,521,219,7,747,78.71%
Kennedy Dist 7,564,353,142,7,502,89.01%
Kilbuck,608,361,161,3,525,86.35%
Leet Dist 1,423,279,62,3,344,81.32%
Leet Dist 2,796,431,230,7,668,83.92%
Leetsdale,841,496,132,7,635,75.51%
Liberty Dist 1,889,591,135,3,729,82.00%
Liberty Dist 2,783,539,107,4,650,83.01%
Lincoln,662,459,106,2,567,85.65%
Marshall Dist 1,971,467,306,7,780,80.33%
Marshall Dist 2,1306,660,421,8,1089,83.38%
Marshall Dist 3,837,371,299,5,675,80.65%
Marshall Dist 4,1211,606,419,10,1035,85.47%
Marshall Dist 5,983,479,324,11,814,82.81%
Marshall Dist 6,990,480,322,11,813,82.12%
Marshall Dist 7,1321,585,425,4,1014,76.76%
McCandless Ward 1 Dist 1,1165,569,395,3,967,83.00%
McCandless Ward 1 Dist 2,775,362,233,7,602,77.68%
McCandless Ward 1 Dist 3,1316,591,407,14,1012,76.90%
McCandless Ward 2 Dist 1,1404,666,515,11,1192,84.90%
McCandless Ward 2 Dist 2,877,481,282,6,769,87.69%
McCandless Ward 2 Dist 3,901,484,260,3,747,82.91%
McCandless Ward 3 Dist 1,951,528,284,2,814,85.59%
McCandless Ward 3 Dist 2,1067,601,298,10,909,85.19%
McCandless Ward 3 Dist 3,1110,597,355,8,960,86.49%
McCandless Ward 4 Dist 1,1483,794,470,10,1274,85.91%
McCandless Ward 4 Dist 2,977,560,242,9,811,83.01%
McCandless Ward 4 Dist 3,776,432,243,6,681,87.76%
McCandless Ward 5 Dist 1,896,533,236,3,772,86.16%
McCandless Ward 5 Dist 2,1484,775,400,10,1185,79.85%
McCandless Ward 5 Dist 3,1086,508,399,9,916,84.35%
McCandless Ward 6 Dist 1,475,236,168,2,406,85.47%
McCandless Ward 6 Dist 2,1044,551,340,4,895,85.73%
McCandless Ward 6 Dist 3,1885,867,738,10,1615,85.68%
McCandless Ward 7 Dist 1,1625,748,579,7,1334,82.09%
McCandless Ward 7 Dist 2,1044,523,371,6,900,86.21%
McCandless Ward 7 Dist 3,535,281,185,0,466,87.10%
McDonald,240,153,31,0,184,76.67%
McKeesport Ward 1,13,5,2,0,7,53.85%
McKeesport Ward 2,217,50,21,3,74,34.10%
McKeesport Ward 3 Dist 1,299,104,46,2,152,50.84%
McKeesport Ward 3 Dist 2,105,38,18,1,57,54.29%
McKeesport Ward 4,317,81,28,4,113,35.65%
McKeesport Ward 5,480,147,48,9,204,42.50%
McKeesport Ward 6 Dist 1,327,102,41,8,151,46.18%
McKeesport Ward 6 Dist 2,287,110,30,4,144,50.17%
McKeesport Ward 7 Dist 1,462,188,72,4,264,57.14%
McKeesport Ward 7 Dist 2,270,107,41,8,156,57.78%
McKeesport Ward 7 Dist 3,311,141,27,5,173,55.63%
McKeesport Ward 7 Dist 4,403,149,43,12,204,50.62%
McKeesport Ward 7 Dist 5,535,226,66,13,305,57.01%
McKeesport Ward 7 Dist 6,425,193,40,9,242,56.94%
McKeesport Ward 7 Dist 7,327,122,47,12,181,55.35%
McKeesport Ward 8 Dist 1,267,133,31,8,172,64.42%
McKeesport Ward 8 Dist 2,531,239,106,5,350,65.91%
McKeesport Ward 8 Dist 3,498,210,59,16,285,57.23%
McKeesport Ward 8 Dist 4,462,226,89,9,324,70.13%
McKeesport Ward 8 Dist 5,511,134,43,9,186,36.40%
McKeesport Ward 8 Dist 6,202,97,36,2,135,66.83%
McKeesport Ward 9 Dist 1,475,232,72,8,312,65.68%
McKeesport Ward 9 Dist 2,572,301,57,14,372,65.03%
McKeesport Ward 9 Dist 3,387,170,76,8,254,65.63%
McKeesport Ward 10 Dist 1,277,118,27,4,149,53.79%
McKeesport Ward 10 Dist 2,312,146,58,2,206,66.03%
McKeesport Ward 11 Dist 1,428,224,58,6,288,67.29%
McKeesport Ward 11 Dist 2,377,205,56,6,267,70.82%
McKeesport Ward 11 Dist 3,264,114,66,4,184,69.70%
McKeesport Ward 12 Dist 1,334,172,62,4,238,71.26%
McKeesport Ward 12 Dist 2,370,214,68,0,282,76.22%
McKeesport Ward 12 Dist 3,556,339,133,3,475,85.43%
McKees Rocks Ward 1 Dist 1,179,22,7,2,31,17.32%
McKees Rocks Ward 1 Dist 2,523,192,78,11,281,53.73%
McKees Rocks Ward 2 Dist 1,659,247,70,10,327,49.62%
McKees Rocks Ward 2 Dist 2,591,243,53,5,301,50.93%
McKees Rocks Ward 3 Dist 1,762,340,132,22,494,64.83%
McKees Rocks Ward 3 Dist 2,534,187,73,12,272,50.94%
McKees Rocks Ward 3 Dist 3,511,215,65,6,286,55.97%
Millvale Dist 1,510,260,94,3,357,70.00%
Millvale Dist 2,463,282,51,1,334,72.14%
Millvale Dist 3,453,235,98,1,334,73.73%
Millvale Dist 4,452,252,69,4,325,71.90%
Millvale Dist 5,521,289,110,2,401,76.97%
Monroeville Ward 1 Dist 1,703,403,135,2,540,76.81%
Monroeville Ward 1 Dist 2,636,376,152,7,535,84.12%
Monroeville Ward 1 Dist 3,802,435,238,5,678,84.54%
Monroeville Ward 1 Dist 4,918,392,205,11,608,66.23%
Monroeville Ward 2 Dist 1,956,561,229,5,795,83.16%
Monroeville Ward 2 Dist 2,979,530,282,6,818,83.55%
Monroeville Ward 2 Dist 3,1094,575,312,9,896,81.90%
Monroeville Ward 3 Dist 1,1192,558,384,12,954,80.03%
Monroeville Ward 3 Dist 2,650,388,143,6,537,82.62%
Monroeville Ward 3 Dist 3,989,548,265,4,817,82.61%
Monroeville Ward 3 Dist 4,448,256,126,1,383,85.49%
Monroeville Ward 4 Dist 1,676,391,177,2,570,84.32%
Monroeville Ward 4 Dist 2,1058,573,260,12,845,79.87%
Monroeville Ward 4 Dist 3,1006,618,220,9,847,84.19%
Monroeville Ward 5 Dist 1,613,371,136,3,510,83.20%
Monroeville Ward 5 Dist 2,891,344,218,6,568,63.75%
Monroeville Ward 5 Dist 3,1005,461,289,12,762,75.82%
Monroeville Ward 5 Dist 4,653,299,125,9,433,66.31%
Monroeville Ward 6 Dist 1,835,470,194,7,671,80.36%
Monroeville Ward 6 Dist 2,879,423,237,8,668,76.00%
Monroeville Ward 6 Dist 3,1087,475,176,25,676,62.19%
Monroeville Ward 6 Dist 4,377,133,110,7,250,66.31%
Monroeville Ward 7 Dist 1,1561,810,450,18,1278,81.87%
Monroeville Ward 7 Dist 2,840,466,192,9,667,79.40%
Monroeville Ward 7 Dist 3,705,369,171,10,550,78.01%
Moon Dist 1,892,387,135,6,528,59.19%
Moon Dist 2,1045,561,294,9,864,82.68%
Moon Dist 3,1173,592,242,13,847,72.21%
Moon Dist 4,1206,651,379,7,1037,85.99%
Moon Dist 5,1664,893,489,11,1393,83.71%
Moon Dist 6,1748,914,468,18,1400,80.09%
Moon Dist 7,1239,597,281,19,897,72.40%
Moon Dist 8,1314,718,362,6,1086,82.65%
Moon Dist 9,1130,559,306,9,874,77.35%
Moon Dist 10,1232,652,368,10,1030,83.60%
Moon Dist 11,1179,593,361,9,963,81.68%
Moon Dist 12,1117,648,288,9,945,84.60%
Moon Dist 13,1303,692,389,19,1100,84.42%
Moon Dist 14,810,332,210,7,549,67.78%
Moon Dist 15,1058,583,252,13,848,80.15%
Moon Dist 16,1193,656,337,17,1010,84.66%
Mt Lebanon Ward 1 Dist 1,847,397,310,4,711,83.94%
Mt Lebanon Ward 1 Dist 2,634,360,144,8,512,80.76%
Mt Lebanon Ward 1 Dist 3,643,371,190,6,567,88.18%
Mt Lebanon Ward 1 Dist 4,782,411,241,5,657,84.02%
Mt Lebanon Ward 1 Dist 5,617,344,187,5,536,86.87%
Mt Lebanon Ward 1 Dist 6,1061,492,383,11,886,83.51%
Mt Lebanon Ward 1 Dist 7,774,407,207,8,622,80.36%
Mt Lebanon Ward 2 Dist 1,998,501,349,6,856,85.77%
Mt Lebanon Ward 2 Dist 2,645,329,191,4,524,81.24%
Mt Lebanon Ward 2 Dist 3,697,335,231,1,567,81.35%
Mt Lebanon Ward 2 Dist 4,559,279,177,2,458,81.93%
Mt Lebanon Ward 2 Dist 5,594,326,164,9,499,84.01%
Mt Lebanon Ward 2 Dist 6,600,362,157,0,519,86.50%
Mt Lebanon Ward 2 Dist 7,671,393,172,3,568,84.65%
Mt Lebanon Ward 2 Dist 8,957,359,422,10,791,82.65%
Mt Lebanon Ward 3 Dist 1,686,338,230,4,572,83.38%
Mt Lebanon Ward 3 Dist 2,911,560,213,9,782,85.84%
Mt Lebanon Ward 3 Dist 3,702,374,218,6,598,85.19%
Mt Lebanon Ward 3 Dist 4,719,362,197,7,566,78.72%
Mt Lebanon Ward 3 Dist 5,745,410,230,7,647,86.85%
Mt Lebanon Ward 3 Dist 6,471,270,136,3,409,86.84%
Mt Lebanon Ward 3 Dist 7,886,412,331,3,746,84.20%
Mt Lebanon Ward 3 Dist 8,322,193,81,4,278,86.34%
Mt Lebanon Ward 4 Dist 1,800,410,213,6,629,78.63%
Mt Lebanon Ward 4 Dist 2,912,517,217,6,740,81.14%
Mt Lebanon Ward 4 Dist 3,668,355,172,6,533,79.79%
Mt Lebanon Ward 4 Dist 4,678,386,197,0,583,85.99%
Mt Lebanon Ward 4 Dist 5,646,402,152,4,558,86.38%
Mt Lebanon Ward 4 Dist 6,702,416,176,0,592,84.33%
Mt Lebanon Ward 4 Dist 7,938,432,359,4,795,84.75%
Mt Lebanon Ward 5 Dist 1,600,317,193,5,515,85.83%
Mt Lebanon Ward 5 Dist 2,449,192,119,4,315,70.16%
Mt Lebanon Ward 5 Dist 3,606,310,184,5,499,82.34%
Mt Lebanon Ward 5 Dist 4,635,362,174,3,539,84.88%
Mt Lebanon Ward 5 Dist 5,642,342,212,4,558,86.92%
Mt Lebanon Ward 5 Dist 6,473,267,137,3,407,86.05%
Mt Lebanon Ward 5 Dist 7,842,433,272,5,710,84.32%
Mt Lebanon Ward 5 Dist 8,955,456,271,12,739,77.38%
Mt Oliver Dist 1,722,259,84,28,371,51.39%
Mt Oliver Dist 2,782,311,114,15,440,56.27%
Mt Oliver Dist 3,522,251,54,6,311,59.58%
Mt Oliver Dist 4,307,144,47,6,197,64.17%
Munhall Dist 1,472,201,87,7,295,62.50%
Munhall Dist 2,520,225,91,11,327,62.88%
Munhall Dist 3,523,263,52,9,324,61.95%
Munhall Dist 4,414,184,79,9,272,65.70%
Munhall Dist 5,759,435,141,12,588,77.47%
Munhall Dist 6,724,437,152,6,595,82.18%
Munhall Dist 7,1131,608,277,9,894,79.05%
Munhall Dist 8,669,434,131,8,573,85.65%
Munhall Dist 9,724,386,154,5,545,75.28%
Munhall Dist 10,514,301,97,6,404,78.60%
Munhall Dist 11,953,586,224,10,820,86.04%
Munhall Dist 12,554,371,106,4,481,86.82%
Neville Ward 1,263,155,37,0,192,73.00%
Neville Ward 2,210,108,29,0,137,65.24%
Neville Ward 3,261,162,52,4,218,83.52%
N Braddock Ward 1 Dist 1,232,98,89,4,191,82.33%
N Braddock Ward 1 Dist 2,479,251,81,6,338,70.56%
N Braddock Ward 1 Dist 3,471,218,59,6,283,60.08%
N Braddock Ward 2 Dist 1,444,186,44,5,235,52.93%
N Braddock Ward 2 Dist 2,548,236,104,8,348,63.50%
N Braddock Ward 3 Dist 1,419,156,54,8,218,52.03%
N Braddock Ward 3 Dist 2,471,171,49,13,233,49.47%
N Fayette Dist 1,2253,1164,707,14,1885,83.67%
N Fayette Dist 2,2567,1174,696,46,1916,74.64%
N Fayette Dist 3,2448,1171,709,34,1914,78.19%
N Fayette Dist 4,1242,575,283,34,892,71.82%
N Fayette Dist 5,3294,1660,970,26,2656,80.63%
N Versailles Ward 1 Dist 1,677,367,135,10,512,75.63%
N Versailles Ward 1 Dist 2,646,415,106,4,525,81.27%
N Versailles Ward 2 Dist 1,668,381,110,9,500,74.85%
N Versailles Ward 2 Dist 2,206,92,54,2,148,71.84%
N Versailles Ward 3 Dist 1,518,282,131,1,414,79.92%
N Versailles Ward 3 Dist 2,617,289,160,11,460,74.55%
N Versailles Ward 4 Dist 1,511,289,79,7,375,73.39%
N Versailles Ward 4 Dist 2,418,240,79,2,321,76.79%
N Versailles Ward 5 Dist 1,520,232,74,3,309,59.42%
N Versailles Ward 5 Dist 2,370,146,61,6,213,57.57%
N Versailles Ward 6 Dist 1,647,385,140,4,529,81.76%
N Versailles Ward 6 Dist 2,549,318,134,5,457,83.24%
N Versailles Ward 7,623,301,109,8,418,67.09%
Oakdale Dist 1,615,409,94,3,506,82.28%
Oakdale Dist 2,447,265,111,1,377,84.34%
Oakmont Dist 1,869,511,232,6,749,86.19%
Oakmont Dist 2,1079,529,365,5,899,83.32%
Oakmont Dist 3,763,458,142,16,616,80.73%
Oakmont Dist 4,874,517,214,5,736,84.21%
Oakmont Dist 5,666,416,128,4,548,82.28%
Oakmont Dist 6,1312,654,432,6,1092,83.23%
O'Hara Ward 1 Dist 1,861,348,290,9,647,75.15%
O'Hara Ward 1 Dist 2,651,362,170,8,540,82.95%
O'Hara Ward 2 Dist 1,630,369,174,1,544,86.35%
O'Hara Ward 2 Dist 2,940,467,317,0,784,83.40%
O'Hara Ward 3 Dist 1,868,485,255,5,745,85.83%
O'Hara Ward 3 Dist 2,553,351,115,0,466,84.27%
O'Hara Ward 4 Dist 1,844,382,292,8,682,80.81%
O'Hara Ward 4 Dist 2,620,317,223,3,543,87.58%
O'Hara Ward 5 Dist 1,772,390,272,8,670,86.79%
O'Hara Ward 5 Dist 2,919,462,312,6,780,84.87%
Ohio Dist 1,1704,930,521,15,1466,86.03%
Ohio Dist 2,1840,929,683,7,1619,87.99%
Ohio Dist 3,2162,1128,651,10,1789,82.75%
Glen Osborne,478,284,115,0,399,83.47%
Penn Hills Ward 1 Dist 1,707,279,188,12,479,67.75%
Penn Hills Ward 1 Dist 2,736,315,197,12,524,71.20%
Penn Hills Ward 1 Dist 3,479,191,100,10,301,62.84%
Penn Hills Ward 1 Dist 4,338,127,71,5,203,60.06%
Penn Hills Ward 1 Dist 5,192,75,39,4,118,61.46%
Penn Hills Ward 2 Dist 1,695,282,185,6,473,68.06%
Penn Hills Ward 2 Dist 2,768,318,155,11,484,63.02%
Penn Hills Ward 2 Dist 3,898,425,191,12,628,69.93%
Penn Hills Ward 2 Dist 4,591,298,178,3,479,81.05%
Penn Hills Ward 3 Dist 1,768,352,240,9,601,78.26%
Penn Hills Ward 3 Dist 2,499,261,125,6,392,78.56%
Penn Hills Ward 3 Dist 3,634,256,208,6,470,74.13%
Penn Hills Ward 3 Dist 4,824,342,242,5,589,71.48%
Penn Hills Ward 3 Dist 5,448,200,86,13,299,66.74%
Penn Hills Ward 3 Dist 6,470,234,90,4,328,69.79%
Penn Hills Ward 4 Dist 1,565,278,158,2,438,77.52%
Penn Hills Ward 4 Dist 2,721,360,179,6,545,75.59%
Penn Hills Ward 4 Dist 3,751,363,195,13,571,76.03%
Penn Hills Ward 4 Dist 4,638,292,170,17,479,75.08%
Penn Hills Ward 4 Dist 5,640,302,159,13,474,74.06%
Penn Hills Ward 5 Dist 1,703,327,156,19,502,71.41%
Penn Hills Ward 5 Dist 2,614,287,131,8,426,69.38%
Penn Hills Ward 5 Dist 3,684,356,168,15,539,78.80%
Penn Hills Ward 5 Dist 4,613,295,196,10,501,81.73%
Penn Hills Ward 5 Dist 5,542,287,143,6,436,80.44%
Penn Hills Ward 5 Dist 6,739,358,189,15,562,76.05%
Penn Hills Ward 6 Dist 1,562,298,108,7,413,73.49%
Penn Hills Ward 6 Dist 2,670,354,140,6,500,74.63%
Penn Hills Ward 6 Dist 3,521,277,125,3,405,77.74%
Penn Hills Ward 6 Dist 4,579,262,116,2,380,65.63%
Penn Hills Ward 6 Dist 5,608,282,150,10,442,72.70%
Penn Hills Ward 6 Dist 6,549,276,140,4,420,76.50%
Penn Hills Ward 7 Dist 1,648,338,155,3,496,76.54%
Penn Hills Ward 7 Dist 2,683,280,194,12,486,71.16%
Penn Hills Ward 7 Dist 3,896,426,239,9,674,75.22%
Penn Hills Ward 7 Dist 4,609,302,174,4,480,78.82%
Penn Hills Ward 7 Dist 5,741,394,186,4,584,78.81%
Penn Hills Ward 7 Dist 6,715,371,153,9,533,74.55%
Penn Hills Ward 7 Dist 7,722,321,181,15,517,71.61%
Penn Hills Ward 8 Dist 1,637,314,198,7,519,81.48%
Penn Hills Ward 8 Dist 2,579,364,111,8,483,83.42%
Penn Hills Ward 8 Dist 3,546,309,139,4,452,82.78%
Penn Hills Ward 8 Dist 4,613,316,192,7,515,84.01%
Penn Hills Ward 8 Dist 5,953,441,292,18,751,78.80%
Penn Hills Ward 8 Dist 6,484,252,147,2,401,82.85%
Penn Hills Ward 9 Dist 1,519,314,133,6,453,87.28%
Penn Hills Ward 9 Dist 2,593,314,154,8,476,80.27%
Penn Hills Ward 9 Dist 3,929,500,235,16,751,80.84%
Penn Hills Ward 9 Dist 4,627,359,156,5,520,82.93%
Penn Hills Ward 9 Dist 5,311,122,73,8,203,65.27%
Pine Dist 1,1568,687,595,17,1299,82.84%
Pine Dist 2,1419,618,571,10,1199,84.50%
Pine Dist 3,1406,677,524,11,1212,86.20%
Pine Dist 4,1518,778,507,4,1289,84.91%
Pine Dist 5,2030,928,654,12,1594,78.52%
Pine Dist 6,1075,576,349,9,934,86.88%
Pine Dist 7,1564,787,502,9,1298,82.99%
Pine Dist 8,1109,535,392,3,930,83.86%
Pitcairn Dist 1,869,429,129,8,566,65.13%
Pitcairn Dist 2,450,193,39,6,238,52.89%
Pitcairn Dist 3,629,384,100,0,484,76.95%
Pittsburgh Ward 1 Dist 1,3874,916,441,50,1407,36.32%
Pittsburgh Ward 1 Dist 2,572,209,116,7,332,58.04%
Pittsburgh Ward 2 Dist 1,2738,852,710,40,1602,58.51%
Pittsburgh Ward 2 Dist 2,2221,818,663,31,1512,68.08%
Pittsburgh Ward 3 Dist 1,237,99,47,2,148,62.45%
Pittsburgh Ward 3 Dist 2,607,266,128,7,401,66.06%
Pittsburgh Ward 3 Dist 3,358,134,85,4,223,62.29%
Pittsburgh Ward 3 Dist 4,571,188,103,9,300,52.54%
Pittsburgh Ward 3 Dist 5,569,191,90,14,295,51.85%
Pittsburgh Ward 4 Dist 1,217,55,19,12,86,39.63%
Pittsburgh Ward 4 Dist 2,787,277,129,18,424,53.88%
Pittsburgh Ward 4 Dist 3,318,118,57,10,185,58.18%
Pittsburgh Ward 4 Dist 4,230,97,25,1,123,53.48%
Pittsburgh Ward 4 Dist 5,1179,491,113,29,633,53.69%
Pittsburgh Ward 4 Dist 6,698,234,86,4,324,46.42%
Pittsburgh Ward 4 Dist 7,2252,722,300,20,1042,46.27%
Pittsburgh Ward 4 Dist 8,2646,957,177,51,1185,44.78%
Pittsburgh Ward 4 Dist 9,997,312,211,22,545,54.66%
Pittsburgh Ward 4 Dist 10,620,207,98,1,306,49.35%
Pittsburgh Ward 4 Dist 11,628,225,237,4,466,74.20%
Pittsburgh Ward 4 Dist 12,717,237,171,4,412,57.46%
Pittsburgh Ward 4 Dist 13,810,344,111,8,463,57.16%
Pittsburgh Ward 4 Dist 14,1632,672,169,8,849,52.02%
Pittsburgh Ward 4 Dist 15,1106,445,136,16,597,53.98%
Pittsburgh Ward 4 Dist 16,1649,657,197,21,875,53.06%
Pittsburgh Ward 4 Dist 17,736,332,117,10,459,62.36%
Pittsburgh Ward 4 Dist 18,805,299,100,26,425,52.80%
Pittsburgh Ward 4 Dist 19,351,126,45,3,174,49.57%
Pittsburgh Ward 5 Dist 1,293,125,27,3,155,52.90%
Pittsburgh Ward 5 Dist 2,364,141,47,10,198,54.40%
Pittsburgh Ward 5 Dist 3,133,67,29,2,98,73.68%
Pittsburgh Ward 5 Dist 4,278,100,42,5,147,52.88%
Pittsburgh Ward 5 Dist 5,176,75,26,3,104,59.09%
Pittsburgh Ward 5 Dist 6,583,159,43,18,220,37.74%
Pittsburgh Ward 5 Dist 7,372,165,67,4,236,63.44%
Pittsburgh Ward 5 Dist 8,423,180,102,5,287,67.85%
Pittsburgh Ward 5 Dist 9,1150,390,235,16,641,55.74%
Pittsburgh Ward 5 Dist 10,457,213,61,12,286,62.58%
Pittsburgh Ward 5 Dist 11,624,306,102,17,425,68.11%
Pittsburgh Ward 5 Dist 12,333,135,52,6,193,57.96%
Pittsburgh Ward 5 Dist 13,270,114,32,6,152,56.30%
Pittsburgh Ward 5 Dist 14,233,80,47,2,129,55.36%
Pittsburgh Ward 5 Dist 15,279,119,30,4,153,54.84%
Pittsburgh Ward 5 Dist 16,197,78,16,7,101,51.27%
Pittsburgh Ward 5 Dist 17,304,126,54,8,188,61.84%
Pittsburgh Ward 5 Dist 18,74,24,15,1,40,54.05%
Pittsburgh Ward 6 Dist 1,1742,804,489,16,1309,75.14%
Pittsburgh Ward 6 Dist 2,594,266,145,4,415,69.87%
Pittsburgh Ward 6 Dist 3,764,372,157,7,536,70.16%
Pittsburgh Ward 6 Dist 4,546,279,135,0,414,75.82%
Pittsburgh Ward 6 Dist 5,503,243,108,8,359,71.37%
Pittsburgh Ward 7 Dist 1,904,415,157,11,583,64.49%
Pittsburgh Ward 7 Dist 2,1143,476,313,8,797,69.73%
Pittsburgh Ward 7 Dist 3,786,265,199,4,468,59.54%
Pittsburgh Ward 7 Dist 4,1095,403,236,14,653,59.63%
Pittsburgh Ward 7 Dist 5,864,305,167,9,481,55.67%
Pittsburgh Ward 7 Dist 6,773,311,182,5,498,64.42%
Pittsburgh Ward 7 Dist 7,839,297,190,14,501,59.71%
Pittsburgh Ward 7 Dist 8,832,329,160,10,499,59.98%
Pittsburgh Ward 7 Dist 9,837,342,199,8,549,65.59%
Pittsburgh Ward 7 Dist 10,1121,434,288,9,731,65.21%
Pittsburgh Ward 7 Dist 11,1259,463,311,2,776,61.64%
Pittsburgh Ward 7 Dist 12,1230,418,351,10,779,63.33%
Pittsburgh Ward 7 Dist 13,616,224,117,3,344,55.84%
Pittsburgh Ward 7 Dist 14,521,222,124,4,350,67.18%
Pittsburgh Ward 8 Dist 1,380,193,78,3,274,72.11%
Pittsburgh Ward 8 Dist 2,634,339,137,7,483,76.18%
Pittsburgh Ward 8 Dist 3,858,393,161,6,560,65.27%
Pittsburgh Ward 8 Dist 4,831,335,192,7,534,64.26%
Pittsburgh Ward 8 Dist 5,610,315,135,7,457,74.92%
Pittsburgh Ward 8 Dist 6,435,208,99,4,311,71.49%
Pittsburgh Ward 8 Dist 7,817,348,173,10,531,64.99%
Pittsburgh Ward 8 Dist 8,638,272,179,3,454,71.16%
Pittsburgh Ward 8 Dist 9,878,342,165,10,517,58.88%
Pittsburgh Ward 8 Dist 10,694,321,149,5,475,68.44%
Pittsburgh Ward 8 Dist 11,737,304,139,11,454,61.60%
Pittsburgh Ward 8 Dist 12,629,307,120,10,437,69.48%
Pittsburgh Ward 8 Dist 13,540,200,91,6,297,55.00%
Pittsburgh Ward 9 Dist 1,651,289,153,10,452,69.43%
Pittsburgh Ward 9 Dist 2,658,324,162,8,494,75.08%
Pittsburgh Ward 9 Dist 3,699,320,174,9,503,71.96%
Pittsburgh Ward 9 Dist 4,634,290,156,5,451,71.14%
Pittsburgh Ward 9 Dist 5,653,301,172,6,479,73.35%
Pittsburgh Ward 9 Dist 6,565,292,134,9,435,76.99%
Pittsburgh Ward 9 Dist 7,417,176,134,5,315,75.54%
Pittsburgh Ward 9 Dist 8,735,378,154,3,535,72.79%
Pittsburgh Ward 9 Dist 9,602,252,135,14,401,66.61%
Pittsburgh Ward 10 Dist 1,643,309,157,9,475,73.87%
Pittsburgh Ward 10 Dist 2,693,366,132,8,506,73.02%
Pittsburgh Ward 10 Dist 3,697,373,114,7,494,70.88%
Pittsburgh Ward 10 Dist 4,537,318,135,8,461,85.85%
Pittsburgh Ward 10 Dist 5,490,287,93,4,384,78.37%
Pittsburgh Ward 10 Dist 6,493,273,108,4,385,78.09%
Pittsburgh Ward 10 Dist 7,608,337,152,5,494,81.25%
Pittsburgh Ward 10 Dist 8,593,332,154,1,487,82.12%
Pittsburgh Ward 10 Dist 9,538,322,122,6,450,83.64%
Pittsburgh Ward 10 Dist 10,609,352,163,6,521,85.55%
Pittsburgh Ward 10 Dist 11,597,334,137,4,475,79.56%
Pittsburgh Ward 10 Dist 12,487,230,136,9,375,77.00%
Pittsburgh Ward 10 Dist 13,531,277,127,11,415,78.15%
Pittsburgh Ward 10 Dist 14,556,304,138,6,448,80.58%
Pittsburgh Ward 10 Dist 15,355,114,83,3,200,56.34%
Pittsburgh Ward 10 Dist 16,316,154,36,5,195,61.71%
Pittsburgh Ward 10 Dist 17,486,222,100,4,326,67.08%
Pittsburgh Ward 10 Dist 18,528,216,124,11,351,66.48%
Pittsburgh Ward 10 Dist 19,441,208,87,7,302,68.48%
Pittsburgh Ward 11 Dist 1,624,298,160,8,466,74.68%
Pittsburgh Ward 11 Dist 2,524,218,114,6,338,64.50%
Pittsburgh Ward 11 Dist 3,418,152,116,13,281,67.22%
Pittsburgh Ward 11 Dist 4,536,218,119,7,344,64.18%
Pittsburgh Ward 11 Dist 5,557,259,101,4,364,65.35%
Pittsburgh Ward 11 Dist 6,834,378,209,6,593,71.10%
Pittsburgh Ward 11 Dist 7,679,313,213,4,530,78.06%
Pittsburgh Ward 11 Dist 8,566,254,158,1,413,72.97%
Pittsburgh Ward 11 Dist 9,644,307,205,4,516,80.12%
Pittsburgh Ward 11 Dist 10,595,304,199,3,506,85.04%
Pittsburgh Ward 11 Dist 11,642,298,168,6,472,73.52%
Pittsburgh Ward 11 Dist 12,681,331,203,3,537,78.85%
Pittsburgh Ward 11 Dist 13,682,354,178,5,537,78.74%
Pittsburgh Ward 11 Dist 14,605,265,123,9,397,65.62%
Pittsburgh Ward 11 Dist 15,409,144,62,7,213,52.08%
Pittsburgh Ward 11 Dist 16,606,237,140,3,380,62.71%
Pittsburgh Ward 11 Dist 17,688,293,161,10,464,67.44%
Pittsburgh Ward 11 Dist 18,643,241,129,17,387,60.19%
Pittsburgh Ward 12 Dist 1,245,65,52,3,120,48.98%
Pittsburgh Ward 12 Dist 2,303,123,27,3,153,50.50%
Pittsburgh Ward 12 Dist 3,184,57,28,7,92,50.00%
Pittsburgh Ward 12 Dist 4,318,123,48,4,175,55.03%
Pittsburgh Ward 12 Dist 5,169,69,13,10,92,54.44%
Pittsburgh Ward 12 Dist 6,195,58,36,5,99,50.77%
Pittsburgh Ward 12 Dist 7,300,105,46,2,153,51.00%
Pittsburgh Ward 12 Dist 8,190,82,19,6,107,56.32%
Pittsburgh Ward 12 Dist 9,286,73,57,8,138,48.25%
Pittsburgh Ward 12 Dist 10,400,173,62,11,246,61.50%
Pittsburgh Ward 12 Dist 11,426,149,78,12,239,56.10%
Pittsburgh Ward 12 Dist 12,716,225,138,19,382,53.35%
Pittsburgh Ward 12 Dist 13,358,152,67,4,223,62.29%
Pittsburgh Ward 12 Dist 14,267,109,46,4,159,59.55%
Pittsburgh Ward 12 Dist 15,520,230,93,3,326,62.69%
Pittsburgh Ward 12 Dist 16,279,100,64,3,167,59.86%
Pittsburgh Ward 13 Dist 1,372,152,64,7,223,59.95%
Pittsburgh Ward 13 Dist 2,338,136,41,3,180,53.25%
Pittsburgh Ward 13 Dist 3,272,104,44,4,152,55.88%
Pittsburgh Ward 13 Dist 4,277,81,56,5,142,51.26%
Pittsburgh Ward 13 Dist 5,297,100,55,6,161,54.21%
Pittsburgh Ward 13 Dist 6,304,132,28,4,164,53.95%
Pittsburgh Ward 13 Dist 7,333,108,44,9,161,48.35%
Pittsburgh Ward 13 Dist 8,294,86,63,2,151,51.36%
Pittsburgh Ward 13 Dist 9,267,109,37,4,150,56.18%
Pittsburgh Ward 13 Dist 10,190,75,27,2,104,54.74%
Pittsburgh Ward 13 Dist 11,380,117,36,3,156,41.05%
Pittsburgh Ward 13 Dist 12,363,148,50,2,200,55.10%
Pittsburgh Ward 13 Dist 13,284,105,40,8,153,53.87%
Pittsburgh Ward 13 Dist 14,227,78,33,1,112,49.34%
Pittsburgh Ward 13 Dist 15,257,114,22,2,138,53.70%
Pittsburgh Ward 13 Dist 16,272,116,40,3,159,58.46%
Pittsburgh Ward 13 Dist 17,816,269,96,7,372,45.59%
Pittsburgh Ward 13 Dist 18,277,95,10,3,108,38.99%
Pittsburgh Ward 13 Dist 19,477,201,127,8,336,70.44%
Pittsburgh Ward 14 Dist 1,968,321,183,14,518,53.51%
Pittsburgh Ward 14 Dist 2,1598,685,178,20,883,55.26%
Pittsburgh Ward 14 Dist 3,1057,436,260,7,703,66.51%
Pittsburgh Ward 14 Dist 4,819,289,291,9,589,71.92%
Pittsburgh Ward 14 Dist 5,855,352,283,6,641,74.97%
Pittsburgh Ward 14 Dist 6,614,320,131,10,461,75.08%
Pittsburgh Ward 14 Dist 7,3338,932,161,66,1159,34.72%
Pittsburgh Ward 14 Dist 8,955,383,202,13,598,62.62%
Pittsburgh Ward 14 Dist 9,762,336,301,7,644,84.51%
Pittsburgh Ward 14 Dist 10,738,335,267,5,607,82.25%
Pittsburgh Ward 14 Dist 11,813,394,250,5,649,79.83%
Pittsburgh Ward 14 Dist 12,841,344,170,7,521,61.95%
Pittsburgh Ward 14 Dist 13,737,342,201,4,547,74.22%
Pittsburgh Ward 14 Dist 14,856,336,292,6,634,74.07%
Pittsburgh Ward 14 Dist 15,742,333,233,6,572,77.09%
Pittsburgh Ward 14 Dist 16,484,236,160,3,399,82.44%
Pittsburgh Ward 14 Dist 17,481,259,149,5,413,85.86%
Pittsburgh Ward 14 Dist 18,742,369,239,4,612,82.48%
Pittsburgh Ward 14 Dist 19,619,320,194,4,518,83.68%
Pittsburgh Ward 14 Dist 20,626,250,196,8,454,72.52%
Pittsburgh Ward 14 Dist 21,608,281,205,8,494,81.25%
Pittsburgh Ward 14 Dist 22,747,348,234,7,589,78.85%
Pittsburgh Ward 14 Dist 23,740,276,282,6,564,76.22%
Pittsburgh Ward 14 Dist 24,547,217,201,5,423,77.33%
Pittsburgh Ward 14 Dist 25,967,400,364,10,774,80.04%
Pittsburgh Ward 14 Dist 26,611,252,221,3,476,77.91%
Pittsburgh Ward 14 Dist 27,543,328,140,3,471,86.74%
Pittsburgh Ward 14 Dist 28,574,326,142,7,475,82.75%
Pittsburgh Ward 14 Dist 29,809,353,249,5,607,75.03%
Pittsburgh Ward 14 Dist 30,660,317,216,5,538,81.52%
Pittsburgh Ward 14 Dist 31,1224,526,456,9,991,80.96%
Pittsburgh Ward 14 Dist 32,815,330,203,11,544,66.75%
Pittsburgh Ward 14 Dist 33,893,323,274,15,612,68.53%
Pittsburgh Ward 14 Dist 34,949,325,279,13,617,65.02%
Pittsburgh Ward 14 Dist 35,662,228,235,8,471,71.15%
Pittsburgh Ward 14 Dist 36,817,269,273,9,551,67.44%
Pittsburgh Ward 14 Dist 37,689,218,241,12,471,68.36%
Pittsburgh Ward 14 Dist 38,621,223,202,5,430,69.24%
Pittsburgh Ward 14 Dist 39,662,237,219,13,469,70.85%
Pittsburgh Ward 14 Dist 40,658,248,157,8,413,62.77%
Pittsburgh Ward 14 Dist 41,74,38,16,3,57,77.03%
Pittsburgh Ward 15 Dist 1,603,204,216,14,434,71.97%
Pittsburgh Ward 15 Dist 2,733,341,169,10,520,70.94%
Pittsburgh Ward 15 Dist 3,640,295,176,7,478,74.69%
Pittsburgh Ward 15 Dist 4,643,287,180,8,475,73.87%
Pittsburgh Ward 15 Dist 5,533,262,126,9,397,74.48%
Pittsburgh Ward 15 Dist 6,530,299,125,9,433,81.70%
Pittsburgh Ward 15 Dist 7,681,368,161,1,530,77.83%
Pittsburgh Ward 15 Dist 8,617,320,162,7,489,79.25%
Pittsburgh Ward 15 Dist 9,165,90,28,2,120,72.73%
Pittsburgh Ward 15 Dist 10,606,313,163,4,480,79.21%
Pittsburgh Ward 15 Dist 11,532,294,129,7,430,80.83%
Pittsburgh Ward 15 Dist 12,468,209,160,2,371,79.27%
Pittsburgh Ward 15 Dist 13,464,175,75,8,258,55.60%
Pittsburgh Ward 15 Dist 14,286,96,49,6,151,52.80%
Pittsburgh Ward 15 Dist 15,329,136,37,8,181,55.02%
Pittsburgh Ward 15 Dist 16,493,208,94,6,308,62.47%
Pittsburgh Ward 15 Dist 17,21,7,6,0,13,61.90%
Pittsburgh Ward 15 Dist 18,546,204,93,14,311,56.96%
Pittsburgh Ward 15 Dist 19,475,129,104,10,243,51.16%
Pittsburgh Ward 16 Dist 1,1049,383,235,16,634,60.44%
Pittsburgh Ward 16 Dist 2,1342,542,305,32,879,65.50%
Pittsburgh Ward 16 Dist 3,1161,520,248,13,781,67.27%
Pittsburgh Ward 16 Dist 4,435,202,74,7,283,65.06%
Pittsburgh Ward 16 Dist 5,678,283,166,13,462,68.14%
Pittsburgh Ward 16 Dist 6,504,244,89,15,348,69.05%
Pittsburgh Ward 16 Dist 7,452,180,80,6,266,58.85%
Pittsburgh Ward 16 Dist 8,187,50,6,7,63,33.69%
Pittsburgh Ward 16 Dist 9,470,216,75,3,294,62.55%
Pittsburgh Ward 16 Dist 10,354,171,70,2,243,68.64%
Pittsburgh Ward 16 Dist 11,405,183,66,5,254,62.72%
Pittsburgh Ward 17 Dist 1,446,153,79,15,247,55.38%
Pittsburgh Ward 17 Dist 2,881,381,151,19,551,62.54%
Pittsburgh Ward 17 Dist 3,654,289,136,14,439,67.13%
Pittsburgh Ward 17 Dist 4,851,356,207,7,570,66.98%
Pittsburgh Ward 17 Dist 5,656,289,127,6,422,64.33%
Pittsburgh Ward 17 Dist 6,467,184,72,9,265,56.75%
Pittsburgh Ward 17 Dist 7,397,174,80,9,263,66.25%
Pittsburgh Ward 17 Dist 8,471,199,106,14,319,67.73%
Pittsburgh Ward 18 Dist 1,546,316,123,6,445,81.50%
Pittsburgh Ward 18 Dist 2,364,139,60,6,205,56.32%
Pittsburgh Ward 18 Dist 3,342,148,52,4,204,59.65%
Pittsburgh Ward 18 Dist 4,430,184,59,15,258,60.00%
Pittsburgh Ward 18 Dist 5,936,417,247,14,678,72.44%
Pittsburgh Ward 18 Dist 6,371,162,47,8,217,58.49%
Pittsburgh Ward 18 Dist 7,446,213,84,5,302,67.71%
Pittsburgh Ward 18 Dist 8,289,102,36,6,144,49.83%
Pittsburgh Ward 18 Dist 9,704,305,109,9,423,60.09%
Pittsburgh Ward 18 Dist 10,66,21,21,0,42,63.64%
Pittsburgh Ward 18 Dist 11,533,195,84,11,290,54.41%
Pittsburgh Ward 19 Dist 1,541,272,165,8,445,82.26%
Pittsburgh Ward 19 Dist 2,730,351,192,10,553,75.75%
Pittsburgh Ward 19 Dist 3,515,266,128,8,402,78.06%
Pittsburgh Ward 19 Dist 4,405,202,128,1,331,81.73%
Pittsburgh Ward 19 Dist 5,416,239,76,5,320,76.92%
Pittsburgh Ward 19 Dist 6,517,239,113,8,360,69.63%
Pittsburgh Ward 19 Dist 7,193,104,32,2,138,71.50%
Pittsburgh Ward 19 Dist 8,610,311,105,5,421,69.02%
Pittsburgh Ward 19 Dist 9,532,255,88,8,351,65.98%
Pittsburgh Ward 19 Dist 10,685,307,139,18,464,67.74%
Pittsburgh Ward 19 Dist 11,449,214,92,5,311,69.27%
Pittsburgh Ward 19 Dist 12,415,221,120,2,343,82.65%
Pittsburgh Ward 19 Dist 13,459,239,58,7,304,66.23%
Pittsburgh Ward 19 Dist 14,557,228,143,7,378,67.86%
Pittsburgh Ward 19 Dist 15,613,304,131,3,438,71.45%
Pittsburgh Ward 19 Dist 16,570,277,129,8,414,72.63%
Pittsburgh Ward 19 Dist 17,542,286,121,10,417,76.94%
Pittsburgh Ward 19 Dist 18,452,251,79,6,336,74.34%
Pittsburgh Ward 19 Dist 19,502,260,100,6,366,72.91%
Pittsburgh Ward 19 Dist 20,523,269,119,6,394,75.33%
Pittsburgh Ward 19 Dist 21,642,323,150,7,480,74.77%
Pittsburgh Ward 19 Dist 22,556,274,138,13,425,76.44%
Pittsburgh Ward 19 Dist 23,613,309,140,3,452,73.74%
Pittsburgh Ward 19 Dist 24,504,290,98,0,388,76.98%
Pittsburgh Ward 19 Dist 25,536,276,133,6,415,77.43%
Pittsburgh Ward 19 Dist 26,460,243,109,5,357,77.61%
Pittsburgh Ward 19 Dist 27,455,228,108,9,345,75.82%
Pittsburgh Ward 19 Dist 28,626,338,189,3,530,84.66%
Pittsburgh Ward 19 Dist 29,492,294,100,5,399,81.10%
Pittsburgh Ward 19 Dist 30,537,281,160,4,445,82.87%
Pittsburgh Ward 19 Dist 31,491,308,101,3,412,83.91%
Pittsburgh Ward 19 Dist 32,533,317,111,6,434,81.43%
Pittsburgh Ward 19 Dist 33,456,263,110,3,376,82.46%
Pittsburgh Ward 19 Dist 34,533,263,146,7,416,78.05%
Pittsburgh Ward 19 Dist 35,506,266,117,6,389,76.88%
Pittsburgh Ward 19 Dist 36,702,367,187,15,569,81.05%
Pittsburgh Ward 19 Dist 37,444,248,100,5,353,79.50%
Pittsburgh Ward 19 Dist 38,586,295,128,4,427,72.87%
Pittsburgh Ward 20 Dist 1,601,331,135,10,476,79.20%
Pittsburgh Ward 20 Dist 2,219,119,41,0,160,73.06%
Pittsburgh Ward 20 Dist 3,664,342,164,4,510,76.81%
Pittsburgh Ward 20 Dist 4,83,28,21,1,50,60.24%
Pittsburgh Ward 20 Dist 5,544,255,118,9,382,70.22%
Pittsburgh Ward 20 Dist 6,527,203,101,12,316,59.96%
Pittsburgh Ward 20 Dist 7,632,286,81,8,375,59.34%
Pittsburgh Ward 20 Dist 8,738,329,131,31,491,66.53%
Pittsburgh Ward 20 Dist 9,209,81,33,5,119,56.94%
Pittsburgh Ward 20 Dist 10,615,258,82,13,353,57.40%
Pittsburgh Ward 20 Dist 11,661,275,77,12,364,55.07%
Pittsburgh Ward 20 Dist 12,911,391,184,7,582,63.89%
Pittsburgh Ward 20 Dist 13,404,201,87,3,291,72.03%
Pittsburgh Ward 20 Dist 14,849,448,133,9,590,69.49%
Pittsburgh Ward 20 Dist 15,867,375,171,15,561,64.71%
Pittsburgh Ward 20 Dist 16,600,312,183,6,501,83.50%
Pittsburgh Ward 20 Dist 17,418,231,119,2,352,84.21%
Pittsburgh Ward 20 Dist 18,490,283,127,5,415,84.69%
Pittsburgh Ward 21 Dist 1,520,197,87,5,289,55.58%
Pittsburgh Ward 21 Dist 2,472,243,83,9,335,70.97%
Pittsburgh Ward 21 Dist 3,608,269,123,10,402,66.12%
Pittsburgh Ward 21 Dist 4,579,261,124,6,391,67.53%
Pittsburgh Ward 22 Dist 1,790,380,200,3,583,73.80%
Pittsburgh Ward 22 Dist 2,671,291,192,4,487,72.58%
Pittsburgh Ward 22 Dist 3,751,300,197,14,511,68.04%
Pittsburgh Ward 22 Dist 4,1007,332,154,16,502,49.85%
Pittsburgh Ward 23 Dist 1,1363,487,279,26,792,58.11%
Pittsburgh Ward 23 Dist 2,792,310,203,12,525,66.29%
Pittsburgh Ward 23 Dist 3,351,152,61,0,213,60.68%
Pittsburgh Ward 24 Dist 1,377,147,112,3,262,69.50%
Pittsburgh Ward 24 Dist 2,418,192,104,5,301,72.01%
Pittsburgh Ward 24 Dist 3,320,157,52,7,216,67.50%
Pittsburgh Ward 24 Dist 4,569,281,152,9,442,77.68%
Pittsburgh Ward 24 Dist 5,491,212,105,11,328,66.80%
Pittsburgh Ward 24 Dist 6,553,265,113,5,383,69.26%
Pittsburgh Ward 25 Dist 1,430,178,108,6,292,67.91%
Pittsburgh Ward 25 Dist 2,456,203,97,5,305,66.89%
Pittsburgh Ward 25 Dist 3,610,278,105,13,396,64.92%
Pittsburgh Ward 25 Dist 4,301,128,43,6,177,58.80%
Pittsburgh Ward 25 Dist 5,356,159,59,6,224,62.92%
Pittsburgh Ward 25 Dist 6,348,116,49,5,170,48.85%
Pittsburgh Ward 25 Dist 7,408,185,110,3,298,73.04%
Pittsburgh Ward 26 Dist 1,508,201,101,11,313,61.61%
Pittsburgh Ward 26 Dist 2,411,153,98,10,261,63.50%
Pittsburgh Ward 26 Dist 3,454,192,79,14,285,62.78%
Pittsburgh Ward 26 Dist 4,376,176,57,4,237,63.03%
Pittsburgh Ward 26 Dist 5,512,174,29,13,216,42.19%
Pittsburgh Ward 26 Dist 6,389,131,27,9,167,42.93%
Pittsburgh Ward 26 Dist 7,275,114,51,4,169,61.45%
Pittsburgh Ward 26 Dist 8,635,169,60,8,237,37.32%
Pittsburgh Ward 26 Dist 9,361,198,78,7,283,78.39%
Pittsburgh Ward 26 Dist 10,626,272,160,5,437,69.81%
Pittsburgh Ward 26 Dist 11,705,348,145,11,504,71.49%
Pittsburgh Ward 26 Dist 12,476,220,89,7,316,66.39%
Pittsburgh Ward 26 Dist 13,562,296,95,7,398,70.82%
Pittsburgh Ward 26 Dist 14,566,338,113,7,458,80.92%
Pittsburgh Ward 26 Dist 15,510,261,136,5,402,78.82%
Pittsburgh Ward 26 Dist 16,709,359,151,8,518,73.06%
Pittsburgh Ward 26 Dist 17,197,96,23,3,122,61.93%
Pittsburgh Ward 27 Dist 1,796,401,235,10,646,81.16%
Pittsburgh Ward 27 Dist 2,670,347,201,3,551,82.24%
Pittsburgh Ward 27 Dist 3,576,305,136,2,443,76.91%
Pittsburgh Ward 27 Dist 4,804,403,177,13,593,73.76%
Pittsburgh Ward 27 Dist 5,706,348,196,7,551,78.05%
Pittsburgh Ward 27 Dist 6,761,334,149,15,498,65.44%
Pittsburgh Ward 27 Dist 7,605,347,115,4,466,77.02%
Pittsburgh Ward 27 Dist 8,574,302,102,4,408,71.08%
Pittsburgh Ward 27 Dist 9,577,259,87,10,356,61.70%
Pittsburgh Ward 27 Dist 10,633,300,106,9,415,65.56%
Pittsburgh Ward 27 Dist 11,648,304,91,13,408,62.96%
Pittsburgh Ward 27 Dist 12,569,259,81,7,347,60.98%
Pittsburgh Ward 27 Dist 13,514,238,99,13,350,68.09%
Pittsburgh Ward 28 Dist 1,629,352,134,13,499,79.33%
Pittsburgh Ward 28 Dist 2,516,239,97,17,353,68.41%
Pittsburgh Ward 28 Dist 3,918,514,223,9,746,81.26%
Pittsburgh Ward 28 Dist 4,644,351,144,16,511,79.35%
Pittsburgh Ward 28 Dist 5,664,376,101,6,483,72.74%
Pittsburgh Ward 28 Dist 6,556,267,161,15,443,79.68%
Pittsburgh Ward 28 Dist 7,621,244,89,8,341,54.91%
Pittsburgh Ward 28 Dist 8,899,523,188,8,719,79.98%
Pittsburgh Ward 28 Dist 9,608,297,137,9,443,72.86%
Pittsburgh Ward 28 Dist 10,577,216,93,4,313,54.25%
Pittsburgh Ward 28 Dist 11,130,68,21,0,89,68.46%
Pittsburgh Ward 29 Dist 1,620,297,95,7,399,64.35%
Pittsburgh Ward 29 Dist 2,536,276,105,8,389,72.57%
Pittsburgh Ward 29 Dist 3,490,217,109,7,333,67.96%
Pittsburgh Ward 29 Dist 4,518,242,84,8,334,64.48%
Pittsburgh Ward 29 Dist 5,539,252,90,6,348,64.56%
Pittsburgh Ward 29 Dist 6,641,322,103,10,435,67.86%
Pittsburgh Ward 29 Dist 7,666,290,174,11,475,71.32%
Pittsburgh Ward 29 Dist 8,581,240,98,7,345,59.38%
Pittsburgh Ward 29 Dist 9,455,206,59,1,266,58.46%
Pittsburgh Ward 29 Dist 10,524,297,89,4,390,74.43%
Pittsburgh Ward 29 Dist 11,657,381,98,9,488,74.28%
Pittsburgh Ward 29 Dist 12,603,294,87,4,385,63.85%
Pittsburgh Ward 30 Dist 1,409,152,51,5,208,50.86%
Pittsburgh Ward 30 Dist 2,375,182,51,3,236,62.93%
Pittsburgh Ward 30 Dist 3,354,105,35,2,142,40.11%
Pittsburgh Ward 30 Dist 4,633,218,96,13,327,51.66%
Pittsburgh Ward 30 Dist 5,653,285,75,12,372,56.97%
Pittsburgh Ward 31 Dist 1,236,112,24,2,138,58.47%
Pittsburgh Ward 31 Dist 2,455,275,123,2,400,87.91%
Pittsburgh Ward 31 Dist 3,528,303,121,21,445,84.28%
Pittsburgh Ward 31 Dist 4,588,351,105,4,460,78.23%
Pittsburgh Ward 31 Dist 5,701,384,202,4,590,84.17%
Pittsburgh Ward 31 Dist 6,554,318,132,3,453,81.77%
Pittsburgh Ward 31 Dist 7,142,80,26,1,107,75.35%
Pittsburgh Ward 32 Dist 1,494,269,112,7,388,78.54%
Pittsburgh Ward 32 Dist 2,637,332,114,8,454,71.27%
Pittsburgh Ward 32 Dist 3,527,289,111,9,409,77.61%
Pittsburgh Ward 32 Dist 4,335,169,84,1,254,75.82%
Pittsburgh Ward 32 Dist 5,552,307,140,8,455,82.43%
Pittsburgh Ward 32 Dist 6,600,337,132,2,471,78.50%
Pittsburgh Ward 32 Dist 7,561,307,129,4,440,78.43%
Pittsburgh Ward 32 Dist 8,663,379,156,8,543,81.90%
Pleasant Hl Dist 1,740,408,158,13,579,78.24%
Pleasant Hl Dist 2,578,356,117,5,478,82.70%
Pleasant Hl Dist 3,566,338,152,8,498,87.99%
Pleasant Hl Dist 4,545,329,123,4,456,83.67%
Pleasant Hl Dist 5,691,318,210,6,534,77.28%
Pleasant Hl Dist 6,1051,642,243,14,899,85.54%
Pleasant Hl Dist 7,560,329,130,4,463,82.68%
Pleasant Hl Dist 8,541,330,141,3,474,87.62%
Pleasant Hl Dist 9,645,387,169,6,562,87.13%
Pleasant Hl Dist 10,522,308,139,7,454,86.97%
Plum Dist 1,1824,978,559,15,1552,85.09%
Plum Dist 2,641,395,129,8,532,83.00%
Plum Dist 3,1080,506,363,10,879,81.39%
Plum Dist 4,870,520,196,5,721,82.87%
Plum Dist 5,926,525,244,3,772,83.37%
Plum Dist 6,1294,836,276,11,1123,86.79%
Plum Dist 7,1266,739,309,16,1064,84.04%
Plum Dist 8,633,375,167,3,545,86.10%
Plum Dist 9,1144,648,353,7,1008,88.11%
Plum Dist 10,598,357,136,9,502,83.95%
Plum Dist 11,821,511,192,3,706,85.99%
Plum Dist 12,1180,680,330,15,1025,86.86%
Plum Dist 13,582,350,139,5,494,84.88%
Plum Dist 14,773,428,182,5,615,79.56%
Plum Dist 15,840,452,177,9,638,75.95%
Plum Dist 16,612,353,161,1,515,84.15%
Plum Dist 17,701,426,141,12,579,82.60%
Plum Dist 18,849,522,220,4,746,87.87%
Plum Dist 19,2159,1246,599,15,1860,86.15%
Plum Dist 20,1018,577,228,3,808,79.37%
Plum Dist 21,446,257,115,3,375,84.08%
Port Vue Dist 1,608,360,92,7,459,75.49%
Port Vue Dist 2,509,320,73,4,397,78.00%
Port Vue Dist 3,524,346,93,10,449,85.69%
Port Vue Dist 4,710,439,109,7,555,78.17%
Rankin Ward 1,314,128,51,4,183,58.28%
Rankin Ward 2,393,186,41,12,239,60.81%
Rankin Ward 3,399,119,45,5,169,42.36%
Reserve Ward 1,537,358,77,2,437,81.38%
Reserve Ward 2,554,366,111,4,481,86.82%
Reserve Ward 3,538,338,119,1,458,85.13%
Reserve Ward 4,824,465,218,2,685,83.13%
Richland Dist 1,1256,711,345,15,1071,85.27%
Richland Dist 2,1250,709,321,8,1038,83.04%
Richland Dist 3,1190,673,323,12,1008,84.71%
Richland Dist 4,1155,694,283,14,991,85.80%
Richland Dist 5,1047,568,302,9,879,83.95%
Richland Dist 6,1165,675,315,11,1001,85.92%
Richland Dist 7,1206,800,255,7,1062,88.06%
Richland Dist 8,1080,535,356,11,902,83.52%
Robinson Dist 1,1698,775,657,11,1443,84.98%
Robinson Dist 2,1289,705,398,11,1114,86.42%
Robinson Dist 3,708,416,165,3,584,82.49%
Robinson Dist 4,1025,542,307,12,861,84.00%
Robinson Dist 5,626,351,186,3,540,86.26%
Robinson Dist 6,922,475,246,8,729,79.07%
Robinson Dist 7,1428,831,426,11,1268,88.80%
Robinson Dist 8,1820,881,427,16,1324,72.75%
Robinson Dist 9,2532,1152,835,21,2008,79.30%
Ross Ward 1 Dist 1,752,449,205,3,657,87.37%
Ross Ward 1 Dist 2,628,317,208,5,530,84.39%
Ross Ward 1 Dist 3,485,272,128,2,402,82.89%
Ross Ward 1 Dist 4,870,522,194,9,725,83.33%
Ross Ward 2 Dist 1,1300,652,373,9,1034,79.54%
Ross Ward 2 Dist 2,927,574,263,0,837,90.29%
Ross Ward 2 Dist 3,685,383,204,7,594,86.72%
Ross Ward 3 Dist 1,681,404,178,4,586,86.05%
Ross Ward 3 Dist 2,702,402,211,5,618,88.03%
Ross Ward 3 Dist 3,596,365,131,3,499,83.72%
Ross Ward 3 Dist 4,683,420,173,6,599,87.70%
Ross Ward 4 Dist 1,830,511,191,3,705,84.94%
Ross Ward 4 Dist 2,1089,645,263,7,915,84.02%
Ross Ward 4 Dist 3,736,411,228,7,646,87.77%
Ross Ward 4 Dist 4,793,436,233,5,674,84.99%
Ross Ward 5 Dist 1,624,378,153,3,534,85.58%
Ross Ward 5 Dist 2,435,268,102,3,373,85.75%
Ross Ward 5 Dist 3,797,361,278,9,648,81.30%
Ross Ward 5 Dist 4,754,440,197,2,639,84.75%
Ross Ward 6 Dist 1,494,300,107,8,415,84.01%
Ross Ward 6 Dist 2,1008,523,271,9,803,79.66%
Ross Ward 6 Dist 3,693,415,147,2,564,81.39%
Ross Ward 6 Dist 4,601,369,112,4,485,80.70%
Ross Ward 7 Dist 1,599,349,168,3,520,86.81%
Ross Ward 7 Dist 2,640,318,127,11,456,71.25%
Ross Ward 7 Dist 3,750,425,203,8,636,84.80%
Ross Ward 7 Dist 4,613,365,130,7,502,81.89%
Ross Ward 8 Dist 1,1701,792,537,22,1351,79.42%
Ross Ward 8 Dist 2,508,266,121,8,395,77.76%
Ross Ward 8 Dist 3,600,345,167,10,522,87.00%
Ross Ward 9 Dist 1,803,495,218,2,715,89.04%
Ross Ward 9 Dist 2,975,537,278,10,825,84.62%
Ross Ward 9 Dist 3,791,447,213,8,668,84.45%
Rosslyn Farms,415,269,89,4,362,87.23%
Scott Ward 1 Dist 1,587,324,86,10,420,71.55%
Scott Ward 1 Dist 2,671,391,91,7,489,72.88%
Scott Ward 2 Dist 1,447,211,130,6,347,77.63%
Scott Ward 2 Dist 2,654,439,123,7,569,87.00%
Scott Ward 3 Dist 1,543,332,141,3,476,87.66%
Scott Ward 3 Dist 2,697,383,199,9,591,84.79%
Scott Ward 4 Dist 1,753,446,199,5,650,86.32%
Scott Ward 4 Dist 2,605,352,169,0,521,86.12%
Scott Ward 5 Dist 1,611,387,120,8,515,84.29%
Scott Ward 5 Dist 2,719,366,217,7,590,82.06%
Scott Ward 6 Dist 1,645,354,144,11,509,78.91%
Scott Ward 6 Dist 2,836,465,225,14,704,84.21%
Scott Ward 7 Dist 1,914,419,316,6,741,81.07%
Scott Ward 7 Dist 2,660,374,191,1,566,85.76%
Scott Ward 8 Dist 1,525,315,148,4,467,88.95%
Scott Ward 8 Dist 2,1057,448,434,10,892,84.39%
Scott Ward 9 Dist 1,347,158,74,6,238,68.59%
Scott Ward 9 Dist 2,367,200,90,3,293,79.84%
Sewickley Ward 1,972,527,250,6,783,80.56%
Sewickley Ward 2 Dist 1,533,239,154,10,403,75.61%
Sewickley Ward 2 Dist 2,595,303,167,3,473,79.50%
Sewickley Ward 3,1061,560,274,14,848,79.92%
Sewickley Hts,790,418,213,4,635,80.38%
Sewickley Hills,578,345,118,4,467,80.80%
Shaler Ward 1 Dist 1,532,337,121,3,461,86.65%
Shaler Ward 1 Dist 2,532,331,114,2,447,84.02%
Shaler Ward 1 Dist 3,575,353,113,4,470,81.74%
Shaler Ward 1 Dist 4,614,384,159,5,548,89.25%
Shaler Ward 1 Dist 5,639,381,143,5,529,82.79%
Shaler Ward 2 Dist 1,1049,637,268,5,910,86.75%
Shaler Ward 2 Dist 2,778,474,195,4,673,86.50%
Shaler Ward 2 Dist 3,619,401,113,9,523,84.49%
Shaler Ward 2 Dist 4,784,505,186,3,694,88.52%
Shaler Ward 2 Dist 5,363,222,93,3,318,87.60%
Shaler Ward 3 Dist 1,603,340,179,2,521,86.40%
Shaler Ward 3 Dist 2,607,379,143,4,526,86.66%
Shaler Ward 3 Dist 3,579,363,146,5,514,88.77%
Shaler Ward 3 Dist 4,719,450,180,5,635,88.32%
Shaler Ward 3 Dist 5,660,400,165,4,569,86.21%
Shaler Ward 4 Dist 1,869,560,187,6,753,86.65%
Shaler Ward 4 Dist 2,456,279,92,3,374,82.02%
Shaler Ward 4 Dist 3,631,382,161,2,545,86.37%
Shaler Ward 4 Dist 4,660,392,176,3,571,86.52%
Shaler Ward 4 Dist 5,520,322,119,0,441,84.81%
Shaler Ward 5 Dist 1,760,470,190,5,665,87.50%
Shaler Ward 5 Dist 2,665,462,134,6,602,90.53%
Shaler Ward 5 Dist 3,544,323,165,3,491,90.26%
Shaler Ward 5 Dist 4,363,242,79,0,321,88.43%
Shaler Ward 5 Dist 5,776,465,196,3,664,85.57%
Shaler Ward 6 Dist 1,620,408,144,4,556,89.68%
Shaler Ward 6 Dist 2,735,460,151,11,622,84.63%
Shaler Ward 6 Dist 3,582,367,152,0,519,89.18%
Shaler Ward 6 Dist 4,335,198,93,4,295,88.06%
Shaler Ward 6 Dist 5,555,322,163,2,487,87.75%
Shaler Ward 7 Dist 1,596,357,145,6,508,85.23%
Shaler Ward 7 Dist 2,782,474,175,3,652,83.38%
Shaler Ward 7 Dist 3,640,374,131,8,513,80.16%
Shaler Ward 7 Dist 4,1025,605,251,7,863,84.20%
Sharpsburg Dist 1,619,320,92,9,421,68.01%
Sharpsburg Dist 2,850,464,119,10,593,69.76%
Sharpsburg Dist 3,843,496,148,10,654,77.58%
S Fayette Dist 1,582,342,169,1,512,87.97%
S Fayette Dist 2,1157,720,260,9,989,85.48%
S Fayette Dist 3,2001,1136,546,16,1698,84.86%
S Fayette Dist 4,875,486,235,10,731,83.54%
S Fayette Dist 5,1074,689,213,8,910,84.73%
S Fayette Dist 6,1289,756,268,14,1038,80.53%
S Fayette Dist 7,734,403,193,5,601,81.88%
S Fayette Dist 8,1603,865,507,12,1384,86.34%
S Fayette Dist 9,708,340,168,7,515,72.74%
S Fayette Dist 10,740,433,159,8,600,81.08%
S Fayette Dist 11,1140,666,251,18,935,82.02%
S Fayette Dist 12,1051,536,321,18,875,83.25%
South Park Dist 1,775,433,217,9,659,85.03%
South Park Dist 2,777,451,183,5,639,82.24%
South Park Dist 3,714,461,150,7,618,86.55%
South Park Dist 4,918,536,193,14,743,80.94%
South Park Dist 5,747,506,135,3,644,86.21%
South Park Dist 6,924,523,207,4,734,79.44%
South Park Dist 7,1100,563,344,8,915,83.18%
South Park Dist 8,527,333,135,2,470,89.18%
South Park Dist 9,853,417,273,7,697,81.71%
South Park Dist 10,897,539,218,8,765,85.28%
South Park Dist 11,598,348,112,5,465,77.76%
South Park Dist 12,601,361,150,5,516,85.86%
South Park Dist 13,1177,649,353,13,1015,86.24%
S Versailles,222,162,29,0,191,86.04%
Springdale Br Dist 1,690,389,137,9,535,77.54%
Springdale Br Dist 2,599,392,118,3,513,85.64%
Springdale Br Dist 3,577,340,102,8,450,77.99%
Springdale Br Dist 4,473,279,83,6,368,77.80%
Springdale Twp,1187,673,302,18,993,83.66%
Stowe Ward 1,454,201,60,7,268,59.03%
Stowe Ward 2 Dist 1,188,70,19,5,94,50.00%
Stowe Ward 2 Dist 2,688,322,118,13,453,65.84%
Stowe Ward 3,359,166,49,6,221,61.56%
Stowe Ward 4 Dist 1,330,156,75,7,238,72.12%
Stowe Ward 4 Dist 2,360,192,113,1,306,85.00%
Stowe Ward 5,443,178,77,4,259,58.47%
Stowe Ward 6,478,201,70,10,281,58.79%
Stowe Ward 7,293,115,22,2,139,47.44%
Stowe Ward 8,397,151,17,1,169,42.57%
Stowe Ward 9,299,99,34,5,138,46.15%
Swissvale Dist 1,849,345,167,14,526,61.96%
Swissvale Dist 2,744,337,143,8,488,65.59%
Swissvale Dist 3,687,301,155,5,461,67.10%
Swissvale Dist 4,619,288,146,12,446,72.05%
Swissvale Dist 5,736,343,219,5,567,77.04%
Swissvale Dist 6,404,174,60,8,242,59.90%
Swissvale Dist 7,675,335,180,12,527,78.07%
Swissvale Dist 8,710,344,168,2,514,72.39%
Swissvale Dist 9,670,344,143,10,497,74.18%
Swissvale Dist 10,240,115,29,2,146,60.83%
Swissvale Dist 11,678,349,198,3,550,81.12%
Tarentum Ward 1 Dist 1,687,383,73,4,460,66.96%
Tarentum Ward 1 Dist 2,470,285,90,3,378,80.43%
Tarentum Ward 2,558,258,104,5,367,65.77%
Tarentum Ward 3 Dist 1,278,151,33,2,186,66.91%
Tarentum Ward 3 Dist 2,593,326,78,5,409,68.97%
Thornburg,407,279,72,4,355,87.22%
Pennsbury Vill,569,370,103,5,478,84.01%
Trafford,55,32,7,1,40,72.73%
Turtle Creek Ward 1 Dist 1,841,448,170,12,630,74.91%
Turtle Creek Ward 1 Dist 2,415,197,62,4,263,63.37%
Turtle Creek Ward 2 Dist 1,704,316,98,10,424,60.23%
Turtle Creek Ward 2 Dist 2,316,135,49,13,197,62.34%
Turtle Creek Ward 3 Dist 1,553,255,74,6,335,60.58%
Turtle Creek Ward 3 Dist 2,453,221,92,11,324,71.52%
Up St Clair Ward 1 Dist 1,501,281,134,3,418,83.43%
Up St Clair Ward 1 Dist 2,822,446,248,3,697,84.79%
Up St Clair Ward 1 Dist 3,1194,662,347,13,1022,85.59%
Up St Clair Ward 1 Dist 4,810,411,251,4,666,82.22%
Up St Clair Ward 2 Dist 1,988,530,277,4,811,82.09%
Up St Clair Ward 2 Dist 2,711,383,199,6,588,82.70%
Up St Clair Ward 2 Dist 3,1082,587,308,12,907,83.83%
Up St Clair Ward 2 Dist 4,545,317,143,4,464,85.14%
Up St Clair Ward 3 Dist 1,1040,548,289,8,845,81.25%
Up St Clair Ward 3 Dist 2,860,506,236,9,751,87.33%
Up St Clair Ward 3 Dist 3,1432,731,452,7,1190,83.10%
Up St Clair Ward 4 Dist 1,1024,576,290,4,870,84.96%
Up St Clair Ward 4 Dist 2,594,324,148,12,484,81.48%
Up St Clair Ward 4 Dist 3,649,358,188,3,549,84.59%
Up St Clair Ward 4 Dist 4,1120,480,392,9,881,78.66%
Up St Clair Ward 5 Dist 1,1149,642,307,8,957,83.29%
Up St Clair Ward 5 Dist 2,1193,689,339,4,1032,86.50%
Up St Clair Ward 5 Dist 3,921,512,273,8,793,86.10%
Verona Dist 1,516,279,69,11,359,69.57%
Verona Dist 2,571,348,98,4,450,78.81%
Verona Dist 3,613,375,98,7,480,78.30%
Versailles Dist 1,517,271,80,8,359,69.44%
Versailles Dist 2,468,224,92,9,325,69.44%
Wall,324,156,50,0,206,63.58%
West Deer Dist 1,1669,1029,404,3,1436,86.04%
West Deer Dist 2,653,446,92,11,549,84.07%
West Deer Dist 3,840,496,188,0,684,81.43%
West Deer Dist 4,833,467,271,3,741,88.96%
West Deer Dist 5,914,604,151,6,761,83.26%
West Deer Dist 6,802,524,147,12,683,85.16%
West Deer Dist 7,1846,952,652,19,1623,87.92%
West Deer Dist 8,1589,801,594,22,1417,89.18%
W Elizabeth,249,160,23,6,189,75.90%
W Homestead Dist 1,424,175,57,15,247,58.25%
W Homestead Dist 2,465,305,97,5,407,87.53%
W Homestead Dist 3,523,318,130,0,448,85.66%
West Mifflin Dist 1,699,410,148,3,561,80.26%
West Mifflin Dist 2,478,244,107,6,357,74.69%
West Mifflin Dist 3,481,281,93,6,380,79.00%
West Mifflin Dist 4,396,83,21,1,105,26.52%
West Mifflin Dist 5,829,538,166,3,707,85.28%
West Mifflin Dist 6,336,194,71,5,270,80.36%
West Mifflin Dist 7,752,457,128,10,595,79.12%
West Mifflin Dist 8,579,308,101,9,418,72.19%
West Mifflin Dist 9,786,421,193,6,620,78.88%
West Mifflin Dist 10,520,298,114,6,418,80.38%
West Mifflin Dist 11,788,446,150,11,607,77.03%
West Mifflin Dist 12,1025,544,202,11,757,73.85%
West Mifflin Dist 13,543,279,113,5,397,73.11%
West Mifflin Dist 14,933,577,215,10,802,85.96%
West Mifflin Dist 15,596,347,132,6,485,81.38%
West Mifflin Dist 16,1160,616,381,8,1005,86.64%
West Mifflin Dist 17,575,335,137,1,473,82.26%
West Mifflin Dist 18,859,500,208,7,715,83.24%
West Mifflin Dist 19,656,415,134,3,552,84.15%
West Mifflin Dist 20,477,279,131,2,412,86.37%
West Mifflin Dist 21,713,357,190,15,562,78.82%
West View Dist 1,679,399,144,9,552,81.30%
West View Dist 2,758,434,137,5,576,75.99%
West View Dist 3,579,330,124,4,458,79.10%
West View Dist 4,600,362,122,16,500,83.33%
West View Dist 5,796,455,197,13,665,83.54%
West View Dist 6,726,457,157,5,619,85.26%
West View Dist 7,620,348,179,5,532,85.81%
Whitaker Dist 1,455,271,54,2,327,71.87%
Whitaker Dist 2,347,180,63,7,250,72.05%
Whitehall Dist 1,568,318,167,4,489,86.09%
Whitehall Dist 2,595,374,122,3,499,83.87%
Whitehall Dist 3,758,398,213,11,622,82.06%
Whitehall Dist 4,662,412,173,5,590,89.12%
Whitehall Dist 5,741,409,192,9,610,82.32%
Whitehall Dist 6,1099,332,190,42,564,51.32%
Whitehall Dist 7,472,251,124,9,384,81.36%
Whitehall Dist 8,823,485,231,8,724,87.97%
Whitehall Dist 9,587,324,173,7,504,85.86%
Whitehall Dist 10,652,395,151,7,553,84.82%
Whitehall Dist 11,637,397,155,5,557,87.44%
Whitehall Dist 12,588,366,127,10,503,85.54%
Whitehall Dist 13,752,403,275,3,681,90.56%
Whitehall Dist 14,616,346,178,6,530,86.04%
Whitehall Dist 15,1024,527,359,1,887,86.62%
Whitehall Dist 16,627,333,187,6,526,83.89%
White Oak Dist 1,736,425,138,5,568,77.17%
White Oak Dist 2,830,466,156,10,632,76.14%
White Oak Dist 3,900,519,207,10,736,81.78%
White Oak Dist 4,737,429,184,4,617,83.72%
White Oak Dist 5,821,474,190,11,675,82.22%
White Oak Dist 6,754,440,173,7,620,82.23%
White Oak Dist 7,1106,645,252,11,908,82.10%
Wilkins Ward 1 Dist 1,772,405,153,6,564,73.06%
Wilkins Ward 1 Dist 2,667,392,171,11,574,86.06%
Wilkins Ward 1 Dist 3,846,465,234,10,709,83.81%
Wilkins Ward 1 Dist 4,633,390,139,2,531,83.89%
Wilkins Ward 1 Dist 5,454,197,116,4,317,69.82%
Wilkins Ward 2 Dist 1,669,404,144,6,554,82.81%
Wilkins Ward 2 Dist 2,924,446,231,15,692,74.89%
Wilkinsburg Ward 1 Dist 1,922,324,168,21,513,55.64%
Wilkinsburg Ward 1 Dist 2,695,273,85,12,370,53.24%
Wilkinsburg Ward 1 Dist 3,415,141,56,9,206,49.64%
Wilkinsburg Ward 1 Dist 4,631,295,166,6,467,74.01%
Wilkinsburg Ward 1 Dist 5,540,243,157,5,405,75.00%
Wilkinsburg Ward 1 Dist 6,930,295,251,40,586,63.01%
Wilkinsburg Ward 2 Dist 1,734,244,168,21,433,58.99%
Wilkinsburg Ward 2 Dist 2,981,433,282,14,729,74.31%
Wilkinsburg Ward 2 Dist 3,754,255,113,18,386,51.19%
Wilkinsburg Ward 2 Dist 4,506,168,68,10,246,48.62%
Wilkinsburg Ward 2 Dist 5,762,231,137,19,387,50.79%
Wilkinsburg Ward 3 Dist 1,733,396,191,5,592,80.76%
Wilkinsburg Ward 3 Dist 2,692,339,164,2,505,72.98%
Wilkinsburg Ward 3 Dist 3,799,269,99,17,385,48.19%
Wilkinsburg Ward 3 Dist 4,1061,456,238,11,705,66.45%
Wilkinsburg Ward 3 Dist 5,1090,415,221,20,656,60.18%
Wilkinsburg Ward 3 Dist 6,516,198,58,13,269,52.13%
Wilmerding Dist 1,481,178,63,7,248,51.56%
Wilmerding Dist 2,695,327,104,6,437,62.88%
Total:,952539,487402,228625,10031,726058,76.22%