County,Registered Voters,Election Day,Absentee,Provisional,Ballots Cast,Voter Turnout
Aleppo,1379,633,341,13,987,71.57 %
Aspinwall Dist 1,864,488,127,5,620,71.76 %
Aspinwall Dist 2,574,290,95,4,389,67.77 %
Aspinwall Dist 3,852,462,140,6,608,71.36 %
Avalon Ward 1,1094,454,150,11,615,56.22 %
Avalon Ward 2 Dist 1,697,299,92,7,398,57.10 %
Avalon Ward 2 Dist 2,460,193,78,5,276,60.00 %
Avalon Ward 3 Dist 1,327,140,57,0,197,60.24 %
Avalon Ward 3 Dist 2,438,166,98,3,267,60.96 %
Avalon Ward 3 Dist 3,495,202,103,6,311,62.83 %
Baldwin Br Dist 1,613,286,117,2,405,66.07 %
Baldwin Br Dist 2,1014,505,214,10,729,71.89 %
Baldwin Br Dist 3,847,417,132,10,559,66.00 %
Baldwin Br Dist 4,770,387,117,4,508,65.97 %
Baldwin Br Dist 5,811,369,136,6,511,63.01 %
Baldwin Br Dist 6,747,363,125,8,496,66.40 %
Baldwin Br Dist 7,811,398,144,5,547,67.45 %
Baldwin Br Dist 8,732,368,145,3,516,70.49 %
Baldwin Br Dist 9,768,335,160,9,504,65.63 %
Baldwin Br Dist 10,1057,254,118,20,392,37.09 %
Baldwin Br Dist 11,1296,386,184,13,583,44.98 %
Baldwin Br Dist 12,635,322,108,4,434,68.35 %
Baldwin Br Dist 13,687,366,120,6,492,71.62 %
Baldwin Br Dist 14,615,329,88,6,423,68.78 %
Baldwin Br Dist 15,787,373,178,1,552,70.14 %
Baldwin Br Dist 16,908,445,134,5,584,64.32 %
Baldwin Br Dist 17,656,312,124,6,442,67.38 %
Baldwin Br Dist 18,932,411,194,6,611,65.56 %
Baldwin Tp Dist 1,803,450,133,2,585,72.85 %
Baldwin Tp Dist 2,735,369,117,4,490,66.67 %
Bell Acres,1203,639,200,6,845,70.24 %
Bellevue Ward 1 Dist 1,987,373,148,13,534,54.10 %
Bellevue Ward 1 Dist 2,941,417,152,6,575,61.11 %
Bellevue Ward 2 Dist 1,1111,446,155,7,608,54.73 %
Bellevue Ward 2 Dist 2,993,416,138,5,559,56.29 %
Bellevue Ward 3 Dist 1,1007,407,152,12,571,56.70 %
Bellevue Ward 3 Dist 2,962,432,143,11,586,60.91 %
Ben Avon Dist 1,478,280,85,1,366,76.57 %
Ben Avon Dist 2,998,549,171,6,726,72.75 %
Ben Avon Ht,340,220,42,2,264,77.65 %
Bethel Park Ward 1 Dist 1,859,414,161,12,587,68.34 %
Bethel Park Ward 1 Dist 2,772,403,128,5,536,69.43 %
Bethel Park Ward 1 Dist 3,824,428,153,14,595,72.21 %
Bethel Park Ward 2 Dist 1,728,405,122,2,529,72.66 %
Bethel Park Ward 2 Dist 2,943,504,170,6,680,72.11 %
Bethel Park Ward 2 Dist 3,1099,572,206,5,783,71.25 %
Bethel Park Ward 3 Dist 1,799,460,136,7,603,75.47 %
Bethel Park Ward 3 Dist 2,1103,527,267,16,810,73.44 %
Bethel Park Ward 3 Dist 3,1085,570,220,9,799,73.64 %
Bethel Park Ward 4 Dist 1,1317,684,251,10,945,71.75 %
Bethel Park Ward 4 Dist 2,801,420,167,2,589,73.53 %
Bethel Park Ward 4 Dist 3,883,442,151,7,600,67.95 %
Bethel Park Ward 5 Dist 1,694,357,115,4,476,68.59 %
Bethel Park Ward 5 Dist 2,636,326,93,4,423,66.51 %
Bethel Park Ward 5 Dist 3,1513,607,384,10,1001,66.16 %
Bethel Park Ward 6 Dist 1,1310,670,214,13,897,68.47 %
Bethel Park Ward 6 Dist 2,954,514,167,7,688,72.12 %
Bethel Park Ward 6 Dist 3,885,445,199,7,651,73.56 %
Bethel Park Ward 7 Dist 1,1182,667,198,8,873,73.86 %
Bethel Park Ward 7 Dist 2,1244,568,257,11,836,67.20 %
Bethel Park Ward 7 Dist 3,754,394,141,7,542,71.88 %
Bethel Park Ward 8 Dist 1,569,293,108,2,403,70.83 %
Bethel Park Ward 8 Dist 2,537,160,135,2,297,55.31 %
Bethel Park Ward 8 Dist 3,1317,677,251,5,933,70.84 %
Bethel Park Ward 8 Dist 4,467,258,77,2,337,72.16 %
Bethel Park Ward 9 Dist 1,587,330,97,2,429,73.08 %
Bethel Park Ward 9 Dist 2,710,334,118,7,459,64.65 %
Bethel Park Ward 9 Dist 3,1397,716,280,6,1002,71.73 %
Blawnox,1011,430,171,15,616,60.93 %
Brackenridge Ward 1,491,220,46,0,266,54.18 %
Brackenridge Ward 2,763,357,106,4,467,61.21 %
Brackenridge Ward 3,667,299,59,2,360,53.97 %
Braddock Ward 1,470,142,51,6,199,42.34 %
Braddock Ward 2,607,185,80,6,271,44.65 %
Braddock Ward 3,432,127,29,3,159,36.81 %
Braddock Hl Dist 1,780,257,154,11,422,54.10 %
Braddock Hl Dist 2,520,258,96,7,361,69.42 %
Bradford Woods,1015,571,169,6,746,73.50 %
Brentwood Dist 1,539,277,84,3,364,67.53 %
Brentwood Dist 2,742,332,94,9,435,58.63 %
Brentwood Dist 3,623,299,81,1,381,61.16 %
Brentwood Dist 4,798,349,133,6,488,61.15 %
Brentwood Dist 5,724,284,98,6,388,53.59 %
Brentwood Dist 6,690,241,103,5,349,50.58 %
Brentwood Dist 7,766,335,100,13,448,58.49 %
Brentwood Dist 8,727,351,141,10,502,69.05 %
Brentwood Dist 9,610,288,123,2,413,67.70 %
Brentwood Dist 10,537,244,77,5,326,60.71 %
Bridgeville Dist 1,789,366,91,6,463,58.68 %
Bridgeville Dist 2,864,388,101,12,501,57.99 %
Bridgeville Dist 3,861,435,127,6,568,65.97 %
Bridgeville Dist 4,983,465,183,7,655,66.63 %
Carnegie Ward 1 Dist 1,551,227,72,6,305,55.35 %
Carnegie Ward 1 Dist 2,1200,566,165,9,740,61.67 %
Carnegie Ward 1 Dist 3,882,426,123,7,556,63.04 %
Carnegie Ward 1 Dist 4,389,125,57,3,185,47.56 %
Carnegie Ward 2 Dist 1,655,286,81,8,375,57.25 %
Carnegie Ward 2 Dist 2,506,218,78,10,306,60.47 %
Carnegie Ward 2 Dist 3,507,253,110,2,365,71.99 %
Carnegie Ward 2 Dist 4,888,344,116,5,465,52.36 %
Casl Shannon Dist 1,1090,384,182,12,578,53.03 %
Casl Shannon Dist 2,806,418,119,7,544,67.49 %
Casl Shannon Dist 3,854,410,127,8,545,63.82 %
Casl Shannon Dist 4,661,288,116,6,410,62.03 %
Casl Shannon Dist 5,775,374,144,9,527,68.00 %
Casl Shannon Dist 6,644,314,118,13,445,69.10 %
Casl Shannon Dist 7,762,362,148,12,522,68.50 %
Casl Shannon Dist 8,546,282,96,4,382,69.96 %
Chalfant Dist 1,596,258,91,7,356,59.73 %
Cheswick Dist 1,619,341,94,1,436,70.44 %
Cheswick Dist 2,656,377,104,6,487,74.24 %
Churchill Dist 1,720,354,184,2,540,75.00 %
Churchill Dist 2,720,344,176,7,527,73.19 %
Churchill Dist 3,653,322,164,7,493,75.50 %
Churchill Dist 4,723,338,170,4,512,70.82 %
Clairton Ward 1 Dist 1,351,121,28,4,153,43.59 %
Clairton Ward 1 Dist 2,394,155,39,1,195,49.49 %
Clairton Ward 1 Dist 3,327,135,20,7,162,49.54 %
Clairton Ward 2 Dist 1,111,37,5,0,42,37.84 %
Clairton Ward 2 Dist 2,292,87,42,2,131,44.86 %
Clairton Ward 2 Dist 3,433,106,44,0,150,34.64 %
Clairton Ward 3 Dist 1,427,162,54,1,217,50.82 %
Clairton Ward 3 Dist 2,354,117,47,1,165,46.61 %
Clairton Ward 3 Dist 3,370,85,34,0,119,32.16 %
Clairton Ward 4 Dist 1,366,121,35,0,156,42.62 %
Clairton Ward 4 Dist 2,335,109,25,2,136,40.60 %
Clairton Ward 4 Dist 3,439,180,52,2,234,53.30 %
Collier Dist 1,1477,753,294,7,1054,71.36 %
Collier Dist 2,1374,773,235,1,1009,73.44 %
Collier Dist 3,1280,588,299,9,896,70.00 %
Collier Dist 4,759,366,137,5,508,66.93 %
Collier Dist 5,992,511,209,10,730,73.59 %
Collier Dist 6,1143,504,187,9,700,61.24 %
Coraopolis Ward 1 Dist 1,444,174,51,1,226,50.90 %
Coraopolis Ward 1 Dist 2,498,221,68,2,291,58.43 %
Coraopolis Ward 2,818,290,142,5,437,53.42 %
Coraopolis Ward 3 Dist 1,567,234,97,9,340,59.96 %
Coraopolis Ward 3 Dist 2,571,249,86,6,341,59.72 %
Coraopolis Ward 4 Dist 1,458,216,64,3,283,61.79 %
Coraopolis Ward 4 Dist 2,543,259,84,3,346,63.72 %
Crafton Ward 1 Dist 1,872,418,145,5,568,65.14 %
Crafton Ward 1 Dist 2,624,296,93,7,396,63.46 %
Crafton Ward 2 Dist 1,629,329,91,5,425,67.57 %
Crafton Ward 2 Dist 2,789,304,131,9,444,56.27 %
Crafton Ward 3 Dist 1,988,472,155,3,630,63.77 %
Crafton Ward 3 Dist 2,605,306,82,6,394,65.12 %
Crescent Ward 1,1076,549,144,6,699,64.96 %
Crescent Ward 2,686,357,84,0,441,64.29 %
Dormont Dist 1,733,290,142,8,440,60.03 %
Dormont Dist 2,536,292,106,5,403,75.19 %
Dormont Dist 3,931,408,179,14,601,64.55 %
Dormont Dist 4,653,310,116,7,433,66.31 %
Dormont Dist 5,1040,454,194,10,658,63.27 %
Dormont Dist 6,527,244,95,5,344,65.28 %
Dormont Dist 7,524,244,101,6,351,66.98 %
Dormont Dist 8,416,212,79,0,291,69.95 %
Dormont Dist 9,551,268,86,5,359,65.15 %
Dormont Dist 10,626,347,105,2,454,72.52 %
Dravosburg Dist 1,550,227,79,7,313,56.91 %
Dravosburg Dist 2,345,165,53,1,219,63.48 %
Dravosburg Dist 3,256,108,40,0,148,57.81 %
Duquesne Ward 1 Dist 1,436,188,56,3,247,56.65 %
Duquesne Ward 1 Dist 2,504,117,59,4,180,35.71 %
Duquesne Ward 1 Dist 3,291,77,20,6,103,35.40 %
Duquesne Ward 1 Dist 4,203,40,18,2,60,29.56 %
Duquesne Ward 2 Dist 1,322,78,41,2,121,37.58 %
Duquesne Ward 2 Dist 2,366,107,43,5,155,42.35 %
Duquesne Ward 2 Dist 3,435,131,50,6,187,42.99 %
Duquesne Ward 3 Dist 1,230,53,26,6,85,36.96 %
Duquesne Ward 3 Dist 2,155,39,15,1,55,35.48 %
Duquesne Ward 3 Dist 3,564,171,73,4,248,43.97 %
East Deer Ward 1,325,156,24,1,181,55.69 %
East Deer Ward 2,583,278,80,1,359,61.58 %
E McKeesport Dist 1,407,197,60,0,257,63.14 %
E McKeesport Dist 2,532,246,58,3,307,57.71 %
E McKeesport Dist 3,470,217,47,3,267,56.81 %
E Pittsburgh Ward 1,361,101,31,3,135,37.40 %
E Pittsburgh Ward 2,409,122,32,7,161,39.36 %
E Pittsburgh Ward 3,495,122,38,4,164,33.13 %
Edgewood Dist 1,1039,465,238,13,716,68.91 %
Edgewood Dist 2,954,429,248,5,682,71.49 %
Edgewood Dist 3,879,360,253,9,622,70.76 %
Edgeworth Dist 1,681,336,133,3,472,69.31 %
Edgeworth Dist 2,770,379,145,6,530,68.83 %
Elizabeth Br,894,390,100,6,496,55.48 %
Elizabeth Tp Ward 1 Dist 1,551,285,81,11,377,68.42 %
Elizabeth Tp Ward 1 Dist 2,934,524,98,10,632,67.67 %
Elizabeth Tp Ward 2,1308,730,190,3,923,70.57 %
Elizabeth Tp Ward 3,1347,720,216,4,940,69.78 %
Elizabeth Tp Ward 4 Dist 1,904,417,140,7,564,62.39 %
Elizabeth Tp Ward 4 Dist 2,443,247,74,5,326,73.59 %
Elizabeth Tp Ward 5 Dist 1,443,213,38,2,253,57.11 %
Elizabeth Tp Ward 5 Dist 2,816,411,89,3,503,61.64 %
Elizabeth Tp Ward 6 Dist 1,605,342,78,3,423,69.92 %
Elizabeth Tp Ward 6 Dist 2,720,394,77,3,474,65.83 %
Elizabeth Tp Ward 7,1250,619,191,30,840,67.20 %
Emsworth Dist 1,792,385,112,2,499,63.01 %
Emsworth Dist 2,1004,443,133,7,583,58.07 %
Etna Ward 1,839,399,108,7,514,61.26 %
Etna Ward 2,683,274,84,9,367,53.73 %
Etna Ward 3,732,385,94,4,483,65.98 %
Fawn Dist 1,556,308,65,1,374,67.27 %
Fawn Dist 2,938,488,127,8,623,66.42 %
Findlay Dist 1,1673,841,204,8,1053,62.94 %
Findlay Dist 2,1929,977,293,8,1278,66.25 %
Findlay Dist 3,1206,638,180,2,820,67.99 %
Forest Hills Dist 1,630,332,163,4,499,79.21 %
Forest Hills Dist 2,655,316,154,2,472,72.06 %
Forest Hills Dist 3,630,300,144,10,454,72.06 %
Forest Hills Dist 4,730,341,134,4,479,65.62 %
Forest Hills Dist 5,722,390,148,2,540,74.79 %
Forest Hills Dist 6,624,330,136,7,473,75.80 %
Forest Hills Dist 7,792,328,94,9,431,54.42 %
Forest Hills Dist 8,729,362,162,4,528,72.43 %
Forward Dist 1,360,212,29,2,243,67.50 %
Forward Dist 2,838,405,118,7,530,63.25 %
Forward Dist 3,386,215,45,1,261,67.62 %
Forward Dist 4,464,254,61,2,317,68.32 %
Fox Chapel Dist 1,874,454,183,6,643,73.57 %
Fox Chapel Dist 2,1052,536,198,6,740,70.34 %
Fox Chapel Dist 3,746,394,185,3,582,78.02 %
Fox Chapel Dist 4,1233,577,293,13,883,71.61 %
Fox Chapel Dist 5,986,461,218,13,692,70.18 %
Franklin Pk Ward 1 Dist 1,1189,590,224,7,821,69.05 %
Franklin Pk Ward 1 Dist 2,1475,644,347,9,1000,67.80 %
Franklin Pk Ward 1 Dist 3,1304,642,298,16,956,73.31 %
Franklin Pk Ward 2 Dist 1,1276,667,254,8,929,72.81 %
Franklin Pk Ward 2 Dist 2,1302,614,302,8,924,70.97 %
Franklin Pk Ward 2 Dist 3,1431,756,321,13,1090,76.17 %
Franklin Pk Ward 3 Dist 1,1334,617,297,11,925,69.34 %
Franklin Pk Ward 3 Dist 2,793,418,167,4,589,74.27 %
Franklin Pk Ward 3 Dist 3,1301,683,293,5,981,75.40 %
Frazer,807,413,112,3,528,65.43 %
Glassport Dist 1,572,273,72,4,349,61.01 %
Glassport Dist 2,429,133,34,4,171,39.86 %
Glassport Dist 3,551,179,61,7,247,44.83 %
Glassport Dist 4,250,77,23,2,102,40.80 %
Glassport Dist 5,473,212,70,3,285,60.25 %
Glassport Dist 6,429,193,41,6,240,55.94 %
Glenfield,150,88,15,2,105,70.00 %
Green Tree Dist 1,793,456,130,5,591,74.53 %
Green Tree Dist 2,1062,563,237,6,806,75.89 %
Green Tree Dist 3,1038,526,176,6,708,68.21 %
Green Tree Dist 4,896,412,158,6,576,64.29 %
Hampton Dist 1,1199,627,246,11,884,73.73 %
Hampton Dist 2,1256,657,230,11,898,71.50 %
Hampton Dist 3,1363,676,284,7,967,70.95 %
Hampton Dist 4,640,330,99,6,435,67.97 %
Hampton Dist 5,714,391,122,2,515,72.13 %
Hampton Dist 6,664,332,129,3,464,69.88 %
Hampton Dist 7,1430,742,295,11,1048,73.29 %
Hampton Dist 8,946,525,173,3,701,74.10 %
Hampton Dist 9,1394,763,250,9,1022,73.31 %
Hampton Dist 10,1579,714,342,11,1067,67.57 %
Hampton Dist 11,1723,986,315,11,1312,76.15 %
Hampton Dist 12,900,502,158,7,667,74.11 %
Hampton Dist 13,753,398,161,2,561,74.50 %
Harmar Dist 1,1296,560,320,7,887,68.44 %
Harmar Dist 2,680,280,96,9,385,56.62 %
Harmar Dist 3,361,192,57,1,250,69.25 %
Harrison Ward 1 Dist 1,287,180,34,1,215,74.91 %
Harrison Ward 1 Dist 2,613,308,125,6,439,71.62 %
Harrison Ward 1 Dist 3,687,377,86,5,468,68.12 %
Harrison Ward 2 Dist 1,324,159,46,1,206,63.58 %
Harrison Ward 2 Dist 2,554,219,53,2,274,49.46 %
Harrison Ward 3 Dist 1,1074,549,204,8,761,70.86 %
Harrison Ward 3 Dist 2,654,373,83,2,458,70.03 %
Harrison Ward 4 Dist 1,690,365,98,4,467,67.68 %
Harrison Ward 4 Dist 2,605,282,83,4,369,60.99 %
Harrison Ward 5 Dist 1,505,158,67,5,230,45.54 %
Harrison Ward 5 Dist 2,791,390,98,4,492,62.20 %
Haysville,64,37,7,0,44,68.75 %
Heidelberg,926,465,102,2,569,61.45 %
Homestead Ward 1 Dist 1,530,189,72,2,263,49.62 %
Homestead Ward 1 Dist 2,347,102,37,0,139,40.06 %
Homestead Ward 2 Dist 1,433,127,43,3,173,39.95 %
Homestead Ward 2 Dist 2,289,112,30,2,144,49.83 %
Homestead Ward 3 Dist 1,437,132,27,4,163,37.30 %
Homestead Ward 3 Dist 2,268,90,23,1,114,42.54 %
Indiana Dist 1,966,482,147,7,636,65.84 %
Indiana Dist 2,871,454,159,2,615,70.61 %
Indiana Dist 3,1542,691,261,8,960,62.26 %
Indiana Dist 4,1149,612,225,9,846,73.63 %
Indiana Dist 5,949,493,181,10,684,72.08 %
Ingram Dist 1,862,432,112,2,546,63.34 %
Ingram Dist 2,628,316,78,4,398,63.38 %
Ingram Dist 3,918,441,146,1,588,64.05 %
Jefferson Hl Dist 1,1800,926,308,13,1247,69.28 %
Jefferson Hl Dist 2,832,405,99,4,508,61.06 %
Jefferson Hl Dist 3,707,362,123,4,489,69.17 %
Jefferson Hl Dist 4,646,279,99,0,378,58.51 %
Jefferson Hl Dist 5,2087,938,362,22,1322,63.34 %
Jefferson Hl Dist 6,1005,596,82,5,683,67.96 %
Jefferson Hl Dist 7,379,205,54,1,260,68.60 %
Jefferson Hl Dist 8,1375,743,242,4,989,71.93 %
Kennedy Dist 1,1479,774,293,8,1075,72.68 %
Kennedy Dist 2,866,347,158,6,511,59.01 %
Kennedy Dist 3,994,513,213,5,731,73.54 %
Kennedy Dist 4,467,234,98,3,335,71.73 %
Kennedy Dist 5,1437,762,250,14,1026,71.40 %
Kennedy Dist 6,956,407,184,7,598,62.55 %
Kennedy Dist 7,563,302,102,2,406,72.11 %
Kilbuck,610,345,125,4,474,77.70 %
Leet Dist 1,425,243,41,2,286,67.29 %
Leet Dist 2,804,443,150,2,595,74.00 %
Leetsdale,853,422,85,4,511,59.91 %
Liberty Dist 1,874,459,100,0,559,63.96 %
Liberty Dist 2,779,423,84,0,507,65.08 %
Lincoln,673,387,85,2,474,70.43 %
Marshall Dist 1,947,454,186,2,642,67.79 %
Marshall Dist 2,1204,621,211,5,837,69.52 %
Marshall Dist 3,823,356,203,7,566,68.77 %
Marshall Dist 4,1224,571,280,9,860,70.26 %
Marshall Dist 5,933,406,202,7,615,65.92 %
Marshall Dist 6,1006,478,233,6,717,71.27 %
Marshall Dist 7,1305,528,273,14,815,62.45 %
McCandless Ward 1 Dist 1,1171,553,267,11,831,70.96 %
McCandless Ward 1 Dist 2,805,346,174,8,528,65.59 %
McCandless Ward 1 Dist 3,1290,537,225,11,773,59.92 %
McCandless Ward 2 Dist 1,1418,642,339,5,986,69.53 %
McCandless Ward 2 Dist 2,879,492,168,7,667,75.88 %
McCandless Ward 2 Dist 3,881,457,165,4,626,71.06 %
McCandless Ward 3 Dist 1,961,514,206,3,723,75.23 %
McCandless Ward 3 Dist 2,1093,579,196,8,783,71.64 %
McCandless Ward 3 Dist 3,1117,570,250,6,826,73.95 %
McCandless Ward 4 Dist 1,1482,733,329,6,1068,72.06 %
McCandless Ward 4 Dist 2,960,452,175,10,637,66.35 %
McCandless Ward 4 Dist 3,739,409,160,8,577,78.08 %
McCandless Ward 5 Dist 1,874,509,142,2,653,74.71 %
McCandless Ward 5 Dist 2,1464,668,273,14,955,65.23 %
McCandless Ward 5 Dist 3,1035,455,261,7,723,69.86 %
McCandless Ward 6 Dist 1,480,242,119,3,364,75.83 %
McCandless Ward 6 Dist 2,1039,554,232,4,790,76.03 %
McCandless Ward 6 Dist 3,1883,842,479,19,1340,71.16 %
McCandless Ward 7 Dist 1,1676,743,351,15,1109,66.17 %
McCandless Ward 7 Dist 2,1012,471,261,6,738,72.92 %
McCandless Ward 7 Dist 3,529,274,115,1,390,73.72 %
McDonald,220,110,21,0,131,59.55 %
McKeesport Ward 1,11,1,0,0,1,9.09 %
McKeesport Ward 2,215,25,15,0,40,18.60 %
McKeesport Ward 3 Dist 1,288,72,24,1,97,33.68 %
McKeesport Ward 3 Dist 2,110,23,11,1,35,31.82 %
McKeesport Ward 4,286,54,21,5,80,27.97 %
McKeesport Ward 5,447,101,34,5,140,31.32 %
McKeesport Ward 6 Dist 1,342,60,29,4,93,27.19 %
McKeesport Ward 6 Dist 2,285,67,24,4,95,33.33 %
McKeesport Ward 7 Dist 1,451,147,56,0,203,45.01 %
McKeesport Ward 7 Dist 2,273,85,39,3,127,46.52 %
McKeesport Ward 7 Dist 3,325,97,18,2,117,36.00 %
McKeesport Ward 7 Dist 4,420,110,32,2,144,34.29 %
McKeesport Ward 7 Dist 5,522,163,50,2,215,41.19 %
McKeesport Ward 7 Dist 6,450,140,34,3,177,39.33 %
McKeesport Ward 7 Dist 7,354,104,35,2,141,39.83 %
McKeesport Ward 8 Dist 1,263,106,23,0,129,49.05 %
McKeesport Ward 8 Dist 2,508,180,76,5,261,51.38 %
McKeesport Ward 8 Dist 3,505,141,47,1,189,37.43 %
McKeesport Ward 8 Dist 4,456,198,46,0,244,53.51 %
McKeesport Ward 8 Dist 5,525,104,28,5,137,26.10 %
McKeesport Ward 8 Dist 6,207,80,19,0,99,47.83 %
McKeesport Ward 9 Dist 1,468,172,52,1,225,48.08 %
McKeesport Ward 9 Dist 2,549,218,48,0,266,48.45 %
McKeesport Ward 9 Dist 3,386,137,52,3,192,49.74 %
McKeesport Ward 10 Dist 1,295,88,24,2,114,38.64 %
McKeesport Ward 10 Dist 2,323,110,53,1,164,50.77 %
McKeesport Ward 11 Dist 1,411,173,44,5,222,54.01 %
McKeesport Ward 11 Dist 2,371,133,42,3,178,47.98 %
McKeesport Ward 11 Dist 3,265,100,54,0,154,58.11 %
McKeesport Ward 12 Dist 1,314,144,42,0,186,59.24 %
McKeesport Ward 12 Dist 2,350,177,49,2,228,65.14 %
McKeesport Ward 12 Dist 3,554,292,104,1,397,71.66 %
McKees Rocks Ward 1 Dist 1,263,34,8,1,43,16.35 %
McKees Rocks Ward 1 Dist 2,524,134,54,2,190,36.26 %
McKees Rocks Ward 2 Dist 1,630,173,45,10,228,36.19 %
McKees Rocks Ward 2 Dist 2,580,144,44,5,193,33.28 %
McKees Rocks Ward 3 Dist 1,748,259,104,9,372,49.73 %
McKees Rocks Ward 3 Dist 2,537,137,45,1,183,34.08 %
McKees Rocks Ward 3 Dist 3,542,164,67,4,235,43.36 %
Millvale Dist 1,491,205,64,8,277,56.42 %
Millvale Dist 2,461,198,51,6,255,55.31 %
Millvale Dist 3,429,175,73,5,253,58.97 %
Millvale Dist 4,449,214,51,3,268,59.69 %
Millvale Dist 5,515,221,80,6,307,59.61 %
Monroeville Ward 1 Dist 1,689,311,90,6,407,59.07 %
Monroeville Ward 1 Dist 2,637,311,135,2,448,70.33 %
Monroeville Ward 1 Dist 3,822,393,178,11,582,70.80 %
Monroeville Ward 1 Dist 4,890,277,122,6,405,45.51 %
Monroeville Ward 2 Dist 1,943,476,169,10,655,69.46 %
Monroeville Ward 2 Dist 2,998,459,218,4,681,68.24 %
Monroeville Ward 2 Dist 3,1058,470,247,5,722,68.24 %
Monroeville Ward 3 Dist 1,1191,495,269,13,777,65.24 %
Monroeville Ward 3 Dist 2,646,320,103,7,430,66.56 %
Monroeville Ward 3 Dist 3,979,477,192,5,674,68.85 %
Monroeville Ward 3 Dist 4,445,232,93,2,327,73.48 %
Monroeville Ward 4 Dist 1,651,323,135,1,459,70.51 %
Monroeville Ward 4 Dist 2,1050,488,173,11,672,64.00 %
Monroeville Ward 4 Dist 3,986,503,166,9,678,68.76 %
Monroeville Ward 5 Dist 1,580,270,100,5,375,64.66 %
Monroeville Ward 5 Dist 2,881,253,154,7,414,46.99 %
Monroeville Ward 5 Dist 3,938,357,198,10,565,60.23 %
Monroeville Ward 5 Dist 4,695,219,105,12,336,48.35 %
Monroeville Ward 6 Dist 1,824,378,165,10,553,67.11 %
Monroeville Ward 6 Dist 2,876,340,171,4,515,58.79 %
Monroeville Ward 6 Dist 3,1091,354,133,4,491,45.00 %
Monroeville Ward 6 Dist 4,387,106,91,3,200,51.68 %
Monroeville Ward 7 Dist 1,1474,631,310,3,944,64.04 %
Monroeville Ward 7 Dist 2,838,397,132,7,536,63.96 %
Monroeville Ward 7 Dist 3,664,305,134,6,445,67.02 %
Moon Dist 1,1206,423,158,3,584,48.42 %
Moon Dist 2,1821,848,429,7,1284,70.51 %
Moon Dist 3,1410,569,220,8,797,56.52 %
Moon Dist 4,800,376,147,5,528,66.00 %
Moon Dist 5,2539,1155,504,20,1679,66.13 %
Moon Dist 6,2493,1194,429,19,1642,65.86 %
Moon Dist 7,1624,598,273,15,886,54.56 %
Moon Dist 8,1062,514,197,3,714,67.23 %
Moon Dist 9,2062,838,347,10,1195,57.95 %
Moon Dist 10,778,361,132,9,502,64.52 %
Moon Dist 11,1397,681,271,8,960,68.72 %
Moon Dist 12,1030,558,148,3,709,68.83 %
Moon Dist 13,713,379,108,2,489,68.58 %
Mt Lebanon Ward 1 Dist 1,842,404,198,4,606,71.97 %
Mt Lebanon Ward 1 Dist 2,645,302,117,4,423,65.58 %
Mt Lebanon Ward 1 Dist 3,668,351,140,6,497,74.40 %
Mt Lebanon Ward 1 Dist 4,787,385,183,6,574,72.94 %
Mt Lebanon Ward 1 Dist 5,620,330,134,7,471,75.97 %
Mt Lebanon Ward 1 Dist 6,1063,511,236,7,754,70.93 %
Mt Lebanon Ward 1 Dist 7,785,365,153,8,526,67.01 %
Mt Lebanon Ward 2 Dist 1,1002,488,257,9,754,75.25 %
Mt Lebanon Ward 2 Dist 2,624,307,123,4,434,69.55 %
Mt Lebanon Ward 2 Dist 3,710,319,179,6,504,70.99 %
Mt Lebanon Ward 2 Dist 4,569,260,142,8,410,72.06 %
Mt Lebanon Ward 2 Dist 5,583,297,134,4,435,74.61 %
Mt Lebanon Ward 2 Dist 6,576,318,118,1,437,75.87 %
Mt Lebanon Ward 2 Dist 7,662,353,134,6,493,74.47 %
Mt Lebanon Ward 2 Dist 8,981,383,329,9,721,73.50 %
Mt Lebanon Ward 3 Dist 1,676,330,162,4,496,73.37 %
Mt Lebanon Ward 3 Dist 2,913,499,165,7,671,73.49 %
Mt Lebanon Ward 3 Dist 3,714,357,152,2,511,71.57 %
Mt Lebanon Ward 3 Dist 4,731,304,139,8,451,61.70 %
Mt Lebanon Ward 3 Dist 5,731,380,156,9,545,74.56 %
Mt Lebanon Ward 3 Dist 6,453,243,105,4,352,77.70 %
Mt Lebanon Ward 3 Dist 7,882,378,246,9,633,71.77 %
Mt Lebanon Ward 3 Dist 8,314,170,63,0,233,74.20 %
Mt Lebanon Ward 4 Dist 1,790,349,157,5,511,64.68 %
Mt Lebanon Ward 4 Dist 2,871,435,169,16,620,71.18 %
Mt Lebanon Ward 4 Dist 3,711,330,125,8,463,65.12 %
Mt Lebanon Ward 4 Dist 4,682,369,138,5,512,75.07 %
Mt Lebanon Ward 4 Dist 5,650,372,116,2,490,75.38 %
Mt Lebanon Ward 4 Dist 6,683,382,117,5,504,73.79 %
Mt Lebanon Ward 4 Dist 7,868,371,241,7,619,71.31 %
Mt Lebanon Ward 5 Dist 1,600,287,149,4,440,73.33 %
Mt Lebanon Ward 5 Dist 2,454,166,80,5,251,55.29 %
Mt Lebanon Ward 5 Dist 3,607,276,138,4,418,68.86 %
Mt Lebanon Ward 5 Dist 4,628,337,124,4,465,74.04 %
Mt Lebanon Ward 5 Dist 5,655,317,176,3,496,75.73 %
Mt Lebanon Ward 5 Dist 6,487,250,106,3,359,73.72 %
Mt Lebanon Ward 5 Dist 7,804,413,186,8,607,75.50 %
Mt Lebanon Ward 5 Dist 8,944,397,201,7,605,64.09 %
Mt Oliver Dist 1,721,210,56,1,267,37.03 %
Mt Oliver Dist 2,745,206,79,6,291,39.06 %
Mt Oliver Dist 3,500,137,46,4,187,37.40 %
Mt Oliver Dist 4,319,106,48,5,159,49.84 %
Munhall Dist 1,462,154,56,3,213,46.10 %
Munhall Dist 2,494,154,67,3,224,45.34 %
Munhall Dist 3,508,187,34,9,230,45.28 %
Munhall Dist 4,417,150,63,4,217,52.04 %
Munhall Dist 5,734,350,102,7,459,62.53 %
Munhall Dist 6,718,346,105,5,456,63.51 %
Munhall Dist 7,1141,530,206,10,746,65.38 %
Munhall Dist 8,641,362,101,3,466,72.70 %
Munhall Dist 9,714,322,87,6,415,58.12 %
Munhall Dist 10,530,240,86,1,327,61.70 %
Munhall Dist 11,936,493,164,9,666,71.15 %
Munhall Dist 12,562,319,87,1,407,72.42 %
Neville Ward 1,262,125,22,2,149,56.87 %
Neville Ward 2,224,74,22,0,96,42.86 %
Neville Ward 3,246,136,34,1,171,69.51 %
N Braddock Ward 1 Dist 1,221,100,64,1,165,74.66 %
N Braddock Ward 1 Dist 2,459,186,60,7,253,55.12 %
N Braddock Ward 1 Dist 3,501,149,55,5,209,41.72 %
N Braddock Ward 2 Dist 1,435,137,39,2,178,40.92 %
N Braddock Ward 2 Dist 2,551,197,89,4,290,52.63 %
N Braddock Ward 3 Dist 1,398,111,49,3,163,40.95 %
N Braddock Ward 3 Dist 2,459,136,47,4,187,40.74 %
N Fayette Dist 1,2190,1006,452,4,1462,66.76 %
N Fayette Dist 2,2574,980,413,13,1406,54.62 %
N Fayette Dist 3,2438,970,456,20,1446,59.31 %
N Fayette Dist 4,1184,439,157,7,603,50.93 %
N Fayette Dist 5,3003,1354,534,21,1909,63.57 %
N Versailles Ward 1 Dist 1,664,284,102,2,388,58.43 %
N Versailles Ward 1 Dist 2,629,337,92,4,433,68.84 %
N Versailles Ward 2 Dist 1,647,307,82,6,395,61.05 %
N Versailles Ward 2 Dist 2,198,91,34,0,125,63.13 %
N Versailles Ward 3 Dist 1,489,233,96,4,333,68.10 %
N Versailles Ward 3 Dist 2,634,250,126,5,381,60.09 %
N Versailles Ward 4 Dist 1,498,219,56,5,280,56.22 %
N Versailles Ward 4 Dist 2,399,204,44,5,253,63.41 %
N Versailles Ward 5 Dist 1,533,163,58,2,223,41.84 %
N Versailles Ward 5 Dist 2,383,106,52,4,162,42.30 %
N Versailles Ward 6 Dist 1,639,313,98,3,414,64.79 %
N Versailles Ward 6 Dist 2,541,260,97,0,357,65.99 %
N Versailles Ward 7,665,226,98,4,328,49.32 %
Oakdale Dist 1,614,329,68,4,401,65.31 %
Oakdale Dist 2,448,226,88,2,316,70.54 %
Oakmont Dist 1,869,465,181,3,649,74.68 %
Oakmont Dist 2,1076,515,247,6,768,71.38 %
Oakmont Dist 3,772,425,105,9,539,69.82 %
Oakmont Dist 4,883,441,142,10,593,67.16 %
Oakmont Dist 5,679,367,110,6,483,71.13 %
Oakmont Dist 6,1306,590,317,18,925,70.83 %
O'Hara Ward 1 Dist 1,1088,441,259,11,711,65.35 %
O'Hara Ward 1 Dist 2,622,297,137,11,445,71.54 %
O'Hara Ward 2 Dist 1,621,318,136,6,460,74.07 %
O'Hara Ward 2 Dist 2,941,444,229,11,684,72.69 %
O'Hara Ward 3 Dist 1,683,361,124,6,491,71.89 %
O'Hara Ward 3 Dist 2,595,298,98,4,400,67.23 %
O'Hara Ward 4 Dist 1,585,219,190,2,411,70.26 %
O'Hara Ward 4 Dist 2,787,388,217,7,612,77.76 %
O'Hara Ward 5 Dist 1,757,362,210,11,583,77.01 %
O'Hara Ward 5 Dist 2,917,424,230,2,656,71.54 %
Ohio Dist 1,1553,791,337,7,1135,73.08 %
Ohio Dist 2,1819,879,516,10,1405,77.24 %
Ohio Dist 3,2137,968,445,23,1436,67.20 %
Glen Osborne,472,275,65,2,342,72.46 %
Penn Hills Ward 1 Dist 1,730,195,163,7,365,50.00 %
Penn Hills Ward 1 Dist 2,747,262,157,17,436,58.37 %
Penn Hills Ward 1 Dist 3,490,123,73,6,202,41.22 %
Penn Hills Ward 1 Dist 4,323,89,62,4,155,47.99 %
Penn Hills Ward 1 Dist 5,203,44,34,1,79,38.92 %
Penn Hills Ward 2 Dist 1,710,246,143,9,398,56.06 %
Penn Hills Ward 2 Dist 2,735,230,105,5,340,46.26 %
Penn Hills Ward 2 Dist 3,823,298,147,8,453,55.04 %
Penn Hills Ward 2 Dist 4,583,237,158,5,400,68.61 %
Penn Hills Ward 3 Dist 1,744,311,199,6,516,69.35 %
Penn Hills Ward 3 Dist 2,499,210,79,2,291,58.32 %
Penn Hills Ward 3 Dist 3,643,208,169,4,381,59.25 %
Penn Hills Ward 3 Dist 4,821,234,185,4,423,51.52 %
Penn Hills Ward 3 Dist 5,440,132,68,3,203,46.14 %
Penn Hills Ward 3 Dist 6,474,181,80,4,265,55.91 %
Penn Hills Ward 4 Dist 1,562,232,111,5,348,61.92 %
Penn Hills Ward 4 Dist 2,741,264,124,8,396,53.44 %
Penn Hills Ward 4 Dist 3,742,259,156,8,423,57.01 %
Penn Hills Ward 4 Dist 4,629,234,147,2,383,60.89 %
Penn Hills Ward 4 Dist 5,591,226,103,8,337,57.02 %
Penn Hills Ward 5 Dist 1,696,280,111,8,399,57.33 %
Penn Hills Ward 5 Dist 2,614,229,94,2,325,52.93 %
Penn Hills Ward 5 Dist 3,685,300,142,7,449,65.55 %
Penn Hills Ward 5 Dist 4,602,273,133,6,412,68.44 %
Penn Hills Ward 5 Dist 5,532,252,88,14,354,66.54 %
Penn Hills Ward 5 Dist 6,696,283,144,7,434,62.36 %
Penn Hills Ward 6 Dist 1,558,227,84,10,321,57.53 %
Penn Hills Ward 6 Dist 2,654,253,96,9,358,54.74 %
Penn Hills Ward 6 Dist 3,525,222,101,5,328,62.48 %
Penn Hills Ward 6 Dist 4,568,183,86,5,274,48.24 %
Penn Hills Ward 6 Dist 5,603,213,121,1,335,55.56 %
Penn Hills Ward 6 Dist 6,565,243,108,5,356,63.01 %
Penn Hills Ward 7 Dist 1,644,259,122,22,403,62.58 %
Penn Hills Ward 7 Dist 2,666,217,124,8,349,52.40 %
Penn Hills Ward 7 Dist 3,900,373,168,5,546,60.67 %
Penn Hills Ward 7 Dist 4,610,235,136,11,382,62.62 %
Penn Hills Ward 7 Dist 5,720,299,130,1,430,59.72 %
Penn Hills Ward 7 Dist 6,703,271,116,3,390,55.48 %
Penn Hills Ward 7 Dist 7,692,248,104,5,357,51.59 %
Penn Hills Ward 8 Dist 1,649,275,145,8,428,65.95 %
Penn Hills Ward 8 Dist 2,566,297,87,5,389,68.73 %
Penn Hills Ward 8 Dist 3,535,250,113,6,369,68.97 %
Penn Hills Ward 8 Dist 4,630,283,141,6,430,68.25 %
Penn Hills Ward 8 Dist 5,911,362,208,10,580,63.67 %
Penn Hills Ward 8 Dist 6,474,214,97,3,314,66.24 %
Penn Hills Ward 9 Dist 1,524,283,107,7,397,75.76 %
Penn Hills Ward 9 Dist 2,562,241,122,1,364,64.77 %
Penn Hills Ward 9 Dist 3,879,412,157,7,576,65.53 %
Penn Hills Ward 9 Dist 4,596,292,109,4,405,67.95 %
Penn Hills Ward 9 Dist 5,299,85,64,4,153,51.17 %
Pine Dist 1,1526,702,313,5,1020,66.84 %
Pine Dist 2,2361,1090,519,11,1620,68.61 %
Pine Dist 3,454,232,89,0,321,70.70 %
Pine Dist 4,1457,760,258,11,1029,70.62 %
Pine Dist 5,1987,906,322,16,1244,62.61 %
Pine Dist 6,877,483,154,3,640,72.98 %
Pine Dist 7,1490,712,290,4,1006,67.52 %
Pine Dist 8,1123,600,184,7,791,70.44 %
Pitcairn Dist 1,867,323,73,8,404,46.60 %
Pitcairn Dist 2,438,121,22,4,147,33.56 %
Pitcairn Dist 3,625,303,76,1,380,60.80 %
Pittsburgh Ward 1 Dist 1,3281,390,228,14,632,19.26 %
Pittsburgh Ward 1 Dist 2,657,154,89,7,250,38.05 %
Pittsburgh Ward 2 Dist 1,2507,659,512,8,1179,47.03 %
Pittsburgh Ward 2 Dist 2,1945,621,408,17,1046,53.78 %
Pittsburgh Ward 3 Dist 1,251,81,39,1,121,48.21 %
Pittsburgh Ward 3 Dist 2,632,221,123,7,351,55.54 %
Pittsburgh Ward 3 Dist 3,351,106,63,2,171,48.72 %
Pittsburgh Ward 3 Dist 4,544,107,67,6,180,33.09 %
Pittsburgh Ward 3 Dist 5,508,115,75,11,201,39.57 %
Pittsburgh Ward 4 Dist 1,227,31,13,3,47,20.70 %
Pittsburgh Ward 4 Dist 2,796,217,72,11,300,37.69 %
Pittsburgh Ward 4 Dist 3,326,89,43,3,135,41.41 %
Pittsburgh Ward 4 Dist 4,240,61,30,2,93,38.75 %
Pittsburgh Ward 4 Dist 5,971,261,43,8,312,32.13 %
Pittsburgh Ward 4 Dist 6,747,135,50,6,191,25.57 %
Pittsburgh Ward 4 Dist 7,2270,593,114,11,718,31.63 %
Pittsburgh Ward 4 Dist 8,2610,632,51,16,699,26.78 %
Pittsburgh Ward 4 Dist 9,955,258,169,7,434,45.45 %
Pittsburgh Ward 4 Dist 10,646,182,65,2,249,38.54 %
Pittsburgh Ward 4 Dist 11,583,201,196,5,402,68.95 %
Pittsburgh Ward 4 Dist 12,684,171,124,4,299,43.71 %
Pittsburgh Ward 4 Dist 13,662,153,60,5,218,32.93 %
Pittsburgh Ward 4 Dist 14,1499,406,43,5,454,30.29 %
Pittsburgh Ward 4 Dist 15,1047,271,80,6,357,34.10 %
Pittsburgh Ward 4 Dist 16,1499,414,102,16,532,35.49 %
Pittsburgh Ward 4 Dist 17,645,233,79,3,315,48.84 %
Pittsburgh Ward 4 Dist 18,699,179,53,7,239,34.19 %
Pittsburgh Ward 4 Dist 19,310,74,18,3,95,30.65 %
Pittsburgh Ward 5 Dist 1,258,83,18,5,106,41.09 %
Pittsburgh Ward 5 Dist 2,372,101,45,5,151,40.59 %
Pittsburgh Ward 5 Dist 3,145,49,22,2,73,50.34 %
Pittsburgh Ward 5 Dist 4,269,70,33,1,104,38.66 %
Pittsburgh Ward 5 Dist 5,199,68,24,11,103,51.76 %
Pittsburgh Ward 5 Dist 6,526,93,29,4,126,23.95 %
Pittsburgh Ward 5 Dist 7,386,127,53,6,186,48.19 %
Pittsburgh Ward 5 Dist 8,421,134,83,2,219,52.02 %
Pittsburgh Ward 5 Dist 9,1142,270,177,11,458,40.11 %
Pittsburgh Ward 5 Dist 10,440,162,53,0,215,48.86 %
Pittsburgh Ward 5 Dist 11,361,106,50,8,164,45.43 %
Pittsburgh Ward 5 Dist 12,346,117,51,3,171,49.42 %
Pittsburgh Ward 5 Dist 13,249,68,34,7,109,43.78 %
Pittsburgh Ward 5 Dist 14,251,62,39,1,102,40.64 %
Pittsburgh Ward 5 Dist 15,251,65,11,1,77,30.68 %
Pittsburgh Ward 5 Dist 16,182,49,11,2,62,34.07 %
Pittsburgh Ward 5 Dist 17,272,78,38,2,118,43.38 %
Pittsburgh Ward 5 Dist 18,66,10,8,0,18,27.27 %
Pittsburgh Ward 6 Dist 1,1247,475,262,11,748,59.98 %
Pittsburgh Ward 6 Dist 2,621,228,121,9,358,57.65 %
Pittsburgh Ward 6 Dist 3,791,300,134,16,450,56.89 %
Pittsburgh Ward 6 Dist 4,574,257,97,3,357,62.20 %
Pittsburgh Ward 6 Dist 5,505,207,90,3,300,59.41 %
Pittsburgh Ward 7 Dist 1,712,217,101,8,326,45.79 %
Pittsburgh Ward 7 Dist 2,1138,434,246,9,689,60.54 %
Pittsburgh Ward 7 Dist 3,835,257,131,2,390,46.71 %
Pittsburgh Ward 7 Dist 4,1159,345,176,8,529,45.64 %
Pittsburgh Ward 7 Dist 5,856,257,106,7,370,43.22 %
Pittsburgh Ward 7 Dist 6,760,255,136,12,403,53.03 %
Pittsburgh Ward 7 Dist 7,836,253,152,10,415,49.64 %
Pittsburgh Ward 7 Dist 8,809,260,127,7,394,48.70 %
Pittsburgh Ward 7 Dist 9,843,299,137,5,441,52.31 %
Pittsburgh Ward 7 Dist 10,1169,425,198,9,632,54.06 %
Pittsburgh Ward 7 Dist 11,1270,399,225,9,633,49.84 %
Pittsburgh Ward 7 Dist 12,1197,341,256,7,604,50.46 %
Pittsburgh Ward 7 Dist 13,591,154,81,2,237,40.10 %
Pittsburgh Ward 7 Dist 14,492,164,89,6,259,52.64 %
Pittsburgh Ward 8 Dist 1,384,169,75,5,249,64.84 %
Pittsburgh Ward 8 Dist 2,647,303,103,10,416,64.30 %
Pittsburgh Ward 8 Dist 3,868,328,118,5,451,51.96 %
Pittsburgh Ward 8 Dist 4,857,299,131,6,436,50.88 %
Pittsburgh Ward 8 Dist 5,640,291,106,10,407,63.59 %
Pittsburgh Ward 8 Dist 6,445,186,62,8,256,57.53 %
Pittsburgh Ward 8 Dist 7,843,323,126,8,457,54.21 %
Pittsburgh Ward 8 Dist 8,643,253,124,4,381,59.25 %
Pittsburgh Ward 8 Dist 9,876,302,123,10,435,49.66 %
Pittsburgh Ward 8 Dist 10,688,246,146,10,402,58.43 %
Pittsburgh Ward 8 Dist 11,740,261,103,4,368,49.73 %
Pittsburgh Ward 8 Dist 12,615,246,92,9,347,56.42 %
Pittsburgh Ward 8 Dist 13,534,152,77,6,235,44.01 %
Pittsburgh Ward 9 Dist 1,624,248,115,2,365,58.49 %
Pittsburgh Ward 9 Dist 2,612,258,119,9,386,63.07 %
Pittsburgh Ward 9 Dist 3,657,278,121,3,402,61.19 %
Pittsburgh Ward 9 Dist 4,698,287,114,7,408,58.45 %
Pittsburgh Ward 9 Dist 5,647,263,130,7,400,61.82 %
Pittsburgh Ward 9 Dist 6,577,245,126,7,378,65.51 %
Pittsburgh Ward 9 Dist 7,406,162,102,5,269,66.26 %
Pittsburgh Ward 9 Dist 8,718,310,124,3,437,60.86 %
Pittsburgh Ward 9 Dist 9,617,222,113,6,341,55.27 %
Pittsburgh Ward 10 Dist 1,670,268,132,7,407,60.75 %
Pittsburgh Ward 10 Dist 2,689,309,108,8,425,61.68 %
Pittsburgh Ward 10 Dist 3,712,316,113,11,440,61.80 %
Pittsburgh Ward 10 Dist 4,542,281,121,5,407,75.09 %
Pittsburgh Ward 10 Dist 5,514,258,106,3,367,71.40 %
Pittsburgh Ward 10 Dist 6,503,240,79,9,328,65.21 %
Pittsburgh Ward 10 Dist 7,618,291,136,5,432,69.90 %
Pittsburgh Ward 10 Dist 8,606,300,130,5,435,71.78 %
Pittsburgh Ward 10 Dist 9,537,271,114,4,389,72.44 %
Pittsburgh Ward 10 Dist 10,600,318,138,6,462,77.00 %
Pittsburgh Ward 10 Dist 11,623,278,132,4,414,66.45 %
Pittsburgh Ward 10 Dist 12,512,196,119,2,317,61.91 %
Pittsburgh Ward 10 Dist 13,548,239,117,5,361,65.88 %
Pittsburgh Ward 10 Dist 14,573,267,120,4,391,68.24 %
Pittsburgh Ward 10 Dist 15,365,92,70,6,168,46.03 %
Pittsburgh Ward 10 Dist 16,318,95,37,0,132,41.51 %
Pittsburgh Ward 10 Dist 17,479,169,79,1,249,51.98 %
Pittsburgh Ward 10 Dist 18,552,206,87,5,298,53.99 %
Pittsburgh Ward 10 Dist 19,456,167,67,4,238,52.19 %
Pittsburgh Ward 11 Dist 1,643,239,124,10,373,58.01 %
Pittsburgh Ward 11 Dist 2,547,175,102,12,289,52.83 %
Pittsburgh Ward 11 Dist 3,423,117,77,4,198,46.81 %
Pittsburgh Ward 11 Dist 4,489,149,73,8,230,47.03 %
Pittsburgh Ward 11 Dist 5,566,213,70,0,283,50.00 %
Pittsburgh Ward 11 Dist 6,854,302,169,2,473,55.39 %
Pittsburgh Ward 11 Dist 7,681,307,159,6,472,69.31 %
Pittsburgh Ward 11 Dist 8,591,223,139,7,369,62.44 %
Pittsburgh Ward 11 Dist 9,682,290,169,8,467,68.48 %
Pittsburgh Ward 11 Dist 10,577,274,172,3,449,77.82 %
Pittsburgh Ward 11 Dist 11,643,270,113,6,389,60.50 %
Pittsburgh Ward 11 Dist 12,704,296,181,3,480,68.18 %
Pittsburgh Ward 11 Dist 13,715,312,190,5,507,70.91 %
Pittsburgh Ward 11 Dist 14,628,186,93,1,280,44.59 %
Pittsburgh Ward 11 Dist 15,420,102,37,1,140,33.33 %
Pittsburgh Ward 11 Dist 16,598,178,107,7,292,48.83 %
Pittsburgh Ward 11 Dist 17,674,231,110,15,356,52.82 %
Pittsburgh Ward 11 Dist 18,595,189,83,8,280,47.06 %
Pittsburgh Ward 12 Dist 1,198,37,14,0,51,25.76 %
Pittsburgh Ward 12 Dist 2,311,90,23,3,116,37.30 %
Pittsburgh Ward 12 Dist 3,165,36,22,0,58,35.15 %
Pittsburgh Ward 12 Dist 4,323,122,32,0,154,47.68 %
Pittsburgh Ward 12 Dist 5,139,32,8,2,42,30.22 %
Pittsburgh Ward 12 Dist 6,191,55,21,2,78,40.84 %
Pittsburgh Ward 12 Dist 7,303,71,40,2,113,37.29 %
Pittsburgh Ward 12 Dist 8,201,53,18,2,73,36.32 %
Pittsburgh Ward 12 Dist 9,289,73,46,1,120,41.52 %
Pittsburgh Ward 12 Dist 10,406,136,57,0,193,47.54 %
Pittsburgh Ward 12 Dist 11,430,131,62,1,194,45.12 %
Pittsburgh Ward 12 Dist 12,684,159,105,5,269,39.33 %
Pittsburgh Ward 12 Dist 13,360,115,53,9,177,49.17 %
Pittsburgh Ward 12 Dist 14,288,78,40,2,120,41.67 %
Pittsburgh Ward 12 Dist 15,525,168,86,5,259,49.33 %
Pittsburgh Ward 12 Dist 16,279,91,57,1,149,53.41 %
Pittsburgh Ward 13 Dist 1,336,114,34,2,150,44.64 %
Pittsburgh Ward 13 Dist 2,344,106,30,1,137,39.83 %
Pittsburgh Ward 13 Dist 3,284,77,29,0,106,37.32 %
Pittsburgh Ward 13 Dist 4,286,71,36,3,110,38.46 %
Pittsburgh Ward 13 Dist 5,294,83,40,2,125,42.52 %
Pittsburgh Ward 13 Dist 6,342,106,25,11,142,41.52 %
Pittsburgh Ward 13 Dist 7,341,90,28,0,118,34.60 %
Pittsburgh Ward 13 Dist 8,291,81,32,1,114,39.18 %
Pittsburgh Ward 13 Dist 9,283,73,27,3,103,36.40 %
Pittsburgh Ward 13 Dist 10,181,58,17,1,76,41.99 %
Pittsburgh Ward 13 Dist 11,370,75,24,1,100,27.03 %
Pittsburgh Ward 13 Dist 12,373,112,47,3,162,43.43 %
Pittsburgh Ward 13 Dist 13,265,76,19,4,99,37.36 %
Pittsburgh Ward 13 Dist 14,233,68,19,1,88,37.77 %
Pittsburgh Ward 13 Dist 15,281,105,15,0,120,42.70 %
Pittsburgh Ward 13 Dist 16,271,91,36,3,130,47.97 %
Pittsburgh Ward 13 Dist 17,803,165,74,2,241,30.01 %
Pittsburgh Ward 13 Dist 18,257,56,5,1,62,24.12 %
Pittsburgh Ward 13 Dist 19,480,163,101,4,268,55.83 %
Pittsburgh Ward 14 Dist 1,884,235,102,9,346,39.14 %
Pittsburgh Ward 14 Dist 2,1391,350,132,16,498,35.80 %
Pittsburgh Ward 14 Dist 3,980,363,242,9,614,62.65 %
Pittsburgh Ward 14 Dist 4,809,276,226,10,512,63.29 %
Pittsburgh Ward 14 Dist 5,833,319,232,4,555,66.63 %
Pittsburgh Ward 14 Dist 6,616,197,116,5,318,51.62 %
Pittsburgh Ward 14 Dist 7,3604,456,116,16,588,16.32 %
Pittsburgh Ward 14 Dist 8,893,305,156,3,464,51.96 %
Pittsburgh Ward 14 Dist 9,768,335,221,14,570,74.22 %
Pittsburgh Ward 14 Dist 10,727,308,209,9,526,72.35 %
Pittsburgh Ward 14 Dist 11,834,354,221,13,588,70.50 %
Pittsburgh Ward 14 Dist 12,842,332,121,14,467,55.46 %
Pittsburgh Ward 14 Dist 13,767,316,173,9,498,64.93 %
Pittsburgh Ward 14 Dist 14,910,334,250,9,593,65.16 %
Pittsburgh Ward 14 Dist 15,773,338,156,7,501,64.81 %
Pittsburgh Ward 14 Dist 16,491,231,133,2,366,74.54 %
Pittsburgh Ward 14 Dist 17,473,239,129,6,374,79.07 %
Pittsburgh Ward 14 Dist 18,742,345,188,10,543,73.18 %
Pittsburgh Ward 14 Dist 19,621,338,144,4,486,78.26 %
Pittsburgh Ward 14 Dist 20,623,230,172,8,410,65.81 %
Pittsburgh Ward 14 Dist 21,601,253,157,7,417,69.38 %
Pittsburgh Ward 14 Dist 22,730,305,175,9,489,66.99 %
Pittsburgh Ward 14 Dist 23,742,263,212,4,479,64.56 %
Pittsburgh Ward 14 Dist 24,551,224,134,1,359,65.15 %
Pittsburgh Ward 14 Dist 25,973,374,293,15,682,70.09 %
Pittsburgh Ward 14 Dist 26,602,254,159,4,417,69.27 %
Pittsburgh Ward 14 Dist 27,538,312,107,5,424,78.81 %
Pittsburgh Ward 14 Dist 28,542,289,102,4,395,72.88 %
Pittsburgh Ward 14 Dist 29,822,329,189,8,526,63.99 %
Pittsburgh Ward 14 Dist 30,698,278,193,5,476,68.19 %
Pittsburgh Ward 14 Dist 31,1217,512,342,10,864,70.99 %
Pittsburgh Ward 14 Dist 32,810,282,146,2,430,53.09 %
Pittsburgh Ward 14 Dist 33,848,299,164,15,478,56.37 %
Pittsburgh Ward 14 Dist 34,919,311,159,6,476,51.80 %
Pittsburgh Ward 14 Dist 35,647,204,178,7,389,60.12 %
Pittsburgh Ward 14 Dist 36,847,250,200,3,453,53.48 %
Pittsburgh Ward 14 Dist 37,633,211,143,6,360,56.87 %
Pittsburgh Ward 14 Dist 38,612,198,164,5,367,59.97 %
Pittsburgh Ward 14 Dist 39,652,228,165,4,397,60.89 %
Pittsburgh Ward 14 Dist 40,634,205,110,9,324,51.10 %
Pittsburgh Ward 14 Dist 41,79,40,14,0,54,68.35 %
Pittsburgh Ward 15 Dist 1,607,162,176,8,346,57.00 %
Pittsburgh Ward 15 Dist 2,729,309,121,4,434,59.53 %
Pittsburgh Ward 15 Dist 3,642,257,135,6,398,61.99 %
Pittsburgh Ward 15 Dist 4,652,256,156,9,421,64.57 %
Pittsburgh Ward 15 Dist 5,551,221,113,6,340,61.71 %
Pittsburgh Ward 15 Dist 6,516,259,115,3,377,73.06 %
Pittsburgh Ward 15 Dist 7,718,316,150,8,474,66.02 %
Pittsburgh Ward 15 Dist 8,585,269,115,5,389,66.50 %
Pittsburgh Ward 15 Dist 9,164,71,22,2,95,57.93 %
Pittsburgh Ward 15 Dist 10,613,255,148,4,407,66.39 %
Pittsburgh Ward 15 Dist 11,550,249,102,6,357,64.91 %
Pittsburgh Ward 15 Dist 12,468,180,107,5,292,62.39 %
Pittsburgh Ward 15 Dist 13,458,131,62,6,199,43.45 %
Pittsburgh Ward 15 Dist 14,275,83,33,4,120,43.64 %
Pittsburgh Ward 15 Dist 15,337,91,28,4,123,36.50 %
Pittsburgh Ward 15 Dist 16,500,156,86,5,247,49.40 %
Pittsburgh Ward 15 Dist 17,26,7,4,1,12,46.15 %
Pittsburgh Ward 15 Dist 18,547,151,66,3,220,40.22 %
Pittsburgh Ward 15 Dist 19,441,102,64,6,172,39.00 %
Pittsburgh Ward 16 Dist 1,955,303,157,17,477,49.95 %
Pittsburgh Ward 16 Dist 2,1257,389,198,22,609,48.45 %
Pittsburgh Ward 16 Dist 3,985,360,146,14,520,52.79 %
Pittsburgh Ward 16 Dist 4,408,147,59,2,208,50.98 %
Pittsburgh Ward 16 Dist 5,646,210,113,2,325,50.31 %
Pittsburgh Ward 16 Dist 6,491,188,78,9,275,56.01 %
Pittsburgh Ward 16 Dist 7,419,127,57,1,185,44.15 %
Pittsburgh Ward 16 Dist 8,171,34,5,0,39,22.81 %
Pittsburgh Ward 16 Dist 9,464,165,63,1,229,49.35 %
Pittsburgh Ward 16 Dist 10,357,125,54,5,184,51.54 %
Pittsburgh Ward 16 Dist 11,375,120,40,2,162,43.20 %
Pittsburgh Ward 17 Dist 1,323,86,55,8,149,46.13 %
Pittsburgh Ward 17 Dist 2,857,308,124,8,440,51.34 %
Pittsburgh Ward 17 Dist 3,593,217,91,4,312,52.61 %
Pittsburgh Ward 17 Dist 4,835,322,135,13,470,56.29 %
Pittsburgh Ward 17 Dist 5,613,232,95,4,331,54.00 %
Pittsburgh Ward 17 Dist 6,431,130,48,4,182,42.23 %
Pittsburgh Ward 17 Dist 7,406,156,65,5,226,55.67 %
Pittsburgh Ward 17 Dist 8,440,159,70,9,238,54.09 %
Pittsburgh Ward 18 Dist 1,572,282,95,2,379,66.26 %
Pittsburgh Ward 18 Dist 2,387,130,48,9,187,48.32 %
Pittsburgh Ward 18 Dist 3,348,106,37,6,149,42.82 %
Pittsburgh Ward 18 Dist 4,438,141,67,3,211,48.17 %
Pittsburgh Ward 18 Dist 5,935,342,165,4,511,54.65 %
Pittsburgh Ward 18 Dist 6,378,129,38,4,171,45.24 %
Pittsburgh Ward 18 Dist 7,459,164,55,9,228,49.67 %
Pittsburgh Ward 18 Dist 8,264,68,32,2,102,38.64 %
Pittsburgh Ward 18 Dist 9,692,203,67,1,271,39.16 %
Pittsburgh Ward 18 Dist 10,66,20,14,1,35,53.03 %
Pittsburgh Ward 18 Dist 11,521,149,61,3,213,40.88 %
Pittsburgh Ward 19 Dist 1,554,218,144,6,368,66.43 %
Pittsburgh Ward 19 Dist 2,729,250,141,10,401,55.01 %
Pittsburgh Ward 19 Dist 3,518,223,97,5,325,62.74 %
Pittsburgh Ward 19 Dist 4,401,163,86,1,250,62.34 %
Pittsburgh Ward 19 Dist 5,421,187,70,4,261,62.00 %
Pittsburgh Ward 19 Dist 6,505,183,86,4,273,54.06 %
Pittsburgh Ward 19 Dist 7,224,91,30,2,123,54.91 %
Pittsburgh Ward 19 Dist 8,581,244,83,2,329,56.63 %
Pittsburgh Ward 19 Dist 9,560,180,82,4,266,47.50 %
Pittsburgh Ward 19 Dist 10,667,201,103,8,312,46.78 %
Pittsburgh Ward 19 Dist 11,470,143,80,4,227,48.30 %
Pittsburgh Ward 19 Dist 12,401,189,98,1,288,71.82 %
Pittsburgh Ward 19 Dist 13,491,169,45,6,220,44.81 %
Pittsburgh Ward 19 Dist 14,559,174,115,5,294,52.59 %
Pittsburgh Ward 19 Dist 15,628,250,99,3,352,56.05 %
Pittsburgh Ward 19 Dist 16,608,228,95,2,325,53.45 %
Pittsburgh Ward 19 Dist 17,561,266,84,4,354,63.10 %
Pittsburgh Ward 19 Dist 18,445,179,62,1,242,54.38 %
Pittsburgh Ward 19 Dist 19,512,210,84,6,300,58.59 %
Pittsburgh Ward 19 Dist 20,510,211,93,6,310,60.78 %
Pittsburgh Ward 19 Dist 21,662,279,111,6,396,59.82 %
Pittsburgh Ward 19 Dist 22,558,216,108,9,333,59.68 %
Pittsburgh Ward 19 Dist 23,590,244,97,6,347,58.81 %
Pittsburgh Ward 19 Dist 24,486,212,80,9,301,61.93 %
Pittsburgh Ward 19 Dist 25,524,250,114,0,364,69.47 %
Pittsburgh Ward 19 Dist 26,463,204,79,6,289,62.42 %
Pittsburgh Ward 19 Dist 27,469,179,82,6,267,56.93 %
Pittsburgh Ward 19 Dist 28,642,308,175,6,489,76.17 %
Pittsburgh Ward 19 Dist 29,500,235,83,2,320,64.00 %
Pittsburgh Ward 19 Dist 30,513,199,133,8,340,66.28 %
Pittsburgh Ward 19 Dist 31,468,244,76,3,323,69.02 %
Pittsburgh Ward 19 Dist 32,531,305,74,2,381,71.75 %
Pittsburgh Ward 19 Dist 33,472,216,86,1,303,64.19 %
Pittsburgh Ward 19 Dist 34,539,228,107,8,343,63.64 %
Pittsburgh Ward 19 Dist 35,510,211,102,5,318,62.35 %
Pittsburgh Ward 19 Dist 36,654,286,130,2,418,63.91 %
Pittsburgh Ward 19 Dist 37,443,189,75,3,267,60.27 %
Pittsburgh Ward 19 Dist 38,553,224,104,3,331,59.86 %
Pittsburgh Ward 20 Dist 1,613,283,111,2,396,64.60 %
Pittsburgh Ward 20 Dist 2,215,102,27,2,131,60.93 %
Pittsburgh Ward 20 Dist 3,693,304,133,9,446,64.36 %
Pittsburgh Ward 20 Dist 4,78,21,16,1,38,48.72 %
Pittsburgh Ward 20 Dist 5,540,201,103,3,307,56.85 %
Pittsburgh Ward 20 Dist 6,514,160,73,3,236,45.91 %
Pittsburgh Ward 20 Dist 7,656,230,60,3,293,44.66 %
Pittsburgh Ward 20 Dist 8,702,227,102,1,330,47.01 %
Pittsburgh Ward 20 Dist 9,212,55,29,1,85,40.09 %
Pittsburgh Ward 20 Dist 10,603,175,61,3,239,39.64 %
Pittsburgh Ward 20 Dist 11,695,178,58,9,245,35.25 %
Pittsburgh Ward 20 Dist 12,911,281,154,4,439,48.19 %
Pittsburgh Ward 20 Dist 13,416,150,75,4,229,55.05 %
Pittsburgh Ward 20 Dist 14,860,345,87,7,439,51.05 %
Pittsburgh Ward 20 Dist 15,929,316,136,8,460,49.52 %
Pittsburgh Ward 20 Dist 16,627,256,166,7,429,68.42 %
Pittsburgh Ward 20 Dist 17,410,183,110,1,294,71.71 %
Pittsburgh Ward 20 Dist 18,494,250,73,1,324,65.59 %
Pittsburgh Ward 21 Dist 1,491,147,57,5,209,42.57 %
Pittsburgh Ward 21 Dist 2,475,212,65,3,280,58.95 %
Pittsburgh Ward 21 Dist 3,608,198,92,12,302,49.67 %
Pittsburgh Ward 21 Dist 4,566,214,93,9,316,55.83 %
Pittsburgh Ward 22 Dist 1,763,325,148,4,477,62.52 %
Pittsburgh Ward 22 Dist 2,679,272,147,7,426,62.74 %
Pittsburgh Ward 22 Dist 3,690,233,140,7,380,55.07 %
Pittsburgh Ward 22 Dist 4,921,225,115,9,349,37.89 %
Pittsburgh Ward 23 Dist 1,1288,332,226,18,576,44.72 %
Pittsburgh Ward 23 Dist 2,798,278,158,8,444,55.64 %
Pittsburgh Ward 23 Dist 3,379,118,44,2,164,43.27 %
Pittsburgh Ward 24 Dist 1,418,141,84,1,226,54.07 %
Pittsburgh Ward 24 Dist 2,416,161,76,3,240,57.69 %
Pittsburgh Ward 24 Dist 3,323,114,48,5,167,51.70 %
Pittsburgh Ward 24 Dist 4,562,238,119,7,364,64.77 %
Pittsburgh Ward 24 Dist 5,507,176,76,4,256,50.49 %
Pittsburgh Ward 24 Dist 6,532,236,78,5,319,59.96 %
Pittsburgh Ward 25 Dist 1,433,165,97,1,263,60.74 %
Pittsburgh Ward 25 Dist 2,422,134,67,8,209,49.53 %
Pittsburgh Ward 25 Dist 3,565,205,78,4,287,50.80 %
Pittsburgh Ward 25 Dist 4,291,84,32,1,117,40.21 %
Pittsburgh Ward 25 Dist 5,373,137,39,6,182,48.79 %
Pittsburgh Ward 25 Dist 6,365,77,40,4,121,33.15 %
Pittsburgh Ward 25 Dist 7,389,150,73,6,229,58.87 %
Pittsburgh Ward 26 Dist 1,508,159,82,5,246,48.43 %
Pittsburgh Ward 26 Dist 2,401,118,72,4,194,48.38 %
Pittsburgh Ward 26 Dist 3,421,145,51,4,200,47.51 %
Pittsburgh Ward 26 Dist 4,395,129,45,3,177,44.81 %
Pittsburgh Ward 26 Dist 5,473,82,23,4,109,23.04 %
Pittsburgh Ward 26 Dist 6,374,57,15,3,75,20.05 %
Pittsburgh Ward 26 Dist 7,277,73,36,5,114,41.16 %
Pittsburgh Ward 26 Dist 8,585,126,42,4,172,29.40 %
Pittsburgh Ward 26 Dist 9,365,163,62,5,230,63.01 %
Pittsburgh Ward 26 Dist 10,659,238,133,3,374,56.75 %
Pittsburgh Ward 26 Dist 11,675,267,115,5,387,57.33 %
Pittsburgh Ward 26 Dist 12,471,157,83,2,242,51.38 %
Pittsburgh Ward 26 Dist 13,576,233,81,3,317,55.03 %
Pittsburgh Ward 26 Dist 14,581,280,106,3,389,66.95 %
Pittsburgh Ward 26 Dist 15,498,192,100,7,299,60.04 %
Pittsburgh Ward 26 Dist 16,713,281,112,10,403,56.52 %
Pittsburgh Ward 26 Dist 17,193,74,26,1,101,52.33 %
Pittsburgh Ward 27 Dist 1,803,341,180,11,532,66.25 %
Pittsburgh Ward 27 Dist 2,672,306,162,5,473,70.39 %
Pittsburgh Ward 27 Dist 3,550,230,110,4,344,62.55 %
Pittsburgh Ward 27 Dist 4,794,332,124,14,470,59.19 %
Pittsburgh Ward 27 Dist 5,732,309,170,6,485,66.26 %
Pittsburgh Ward 27 Dist 6,785,278,118,4,400,50.96 %
Pittsburgh Ward 27 Dist 7,596,288,94,3,385,64.60 %
Pittsburgh Ward 27 Dist 8,593,230,83,4,317,53.46 %
Pittsburgh Ward 27 Dist 9,572,194,57,3,254,44.41 %
Pittsburgh Ward 27 Dist 10,637,217,75,6,298,46.78 %
Pittsburgh Ward 27 Dist 11,612,209,57,1,267,43.63 %
Pittsburgh Ward 27 Dist 12,570,191,58,7,256,44.91 %
Pittsburgh Ward 27 Dist 13,538,187,96,3,286,53.16 %
Pittsburgh Ward 28 Dist 1,663,286,101,12,399,60.18 %
Pittsburgh Ward 28 Dist 2,503,162,68,10,240,47.71 %
Pittsburgh Ward 28 Dist 3,874,412,149,7,568,64.99 %
Pittsburgh Ward 28 Dist 4,638,274,125,4,403,63.17 %
Pittsburgh Ward 28 Dist 5,678,295,85,8,388,57.23 %
Pittsburgh Ward 28 Dist 6,542,209,132,5,346,63.84 %
Pittsburgh Ward 28 Dist 7,624,168,85,5,258,41.35 %
Pittsburgh Ward 28 Dist 8,868,416,152,4,572,65.90 %
Pittsburgh Ward 28 Dist 9,615,252,109,10,371,60.33 %
Pittsburgh Ward 28 Dist 10,573,161,49,3,213,37.17 %
Pittsburgh Ward 28 Dist 11,122,47,23,0,70,57.38 %
Pittsburgh Ward 29 Dist 1,606,228,76,3,307,50.66 %
Pittsburgh Ward 29 Dist 2,518,231,71,8,310,59.85 %
Pittsburgh Ward 29 Dist 3,505,156,86,5,247,48.91 %
Pittsburgh Ward 29 Dist 4,504,186,70,4,260,51.59 %
Pittsburgh Ward 29 Dist 5,541,168,69,3,240,44.36 %
Pittsburgh Ward 29 Dist 6,623,241,78,7,326,52.33 %
Pittsburgh Ward 29 Dist 7,653,271,114,5,390,59.72 %
Pittsburgh Ward 29 Dist 8,543,169,67,4,240,44.20 %
Pittsburgh Ward 29 Dist 9,453,152,41,4,197,43.49 %
Pittsburgh Ward 29 Dist 10,537,237,78,3,318,59.22 %
Pittsburgh Ward 29 Dist 11,659,300,72,5,377,57.21 %
Pittsburgh Ward 29 Dist 12,560,196,55,5,256,45.71 %
Pittsburgh Ward 30 Dist 1,402,108,34,3,145,36.07 %
Pittsburgh Ward 30 Dist 2,366,129,37,3,169,46.17 %
Pittsburgh Ward 30 Dist 3,350,60,20,1,81,23.14 %
Pittsburgh Ward 30 Dist 4,598,148,90,1,239,39.97 %
Pittsburgh Ward 30 Dist 5,646,188,67,4,259,40.09 %
Pittsburgh Ward 31 Dist 1,214,76,24,2,102,47.66 %
Pittsburgh Ward 31 Dist 2,448,239,78,2,319,71.21 %
Pittsburgh Ward 31 Dist 3,515,257,87,2,346,67.18 %
Pittsburgh Ward 31 Dist 4,572,300,66,4,370,64.69 %
Pittsburgh Ward 31 Dist 5,679,322,149,4,475,69.96 %
Pittsburgh Ward 31 Dist 6,536,255,87,2,344,64.18 %
Pittsburgh Ward 31 Dist 7,131,53,21,6,80,61.07 %
Pittsburgh Ward 32 Dist 1,493,216,74,8,298,60.45 %
Pittsburgh Ward 32 Dist 2,647,253,92,2,347,53.63 %
Pittsburgh Ward 32 Dist 3,553,248,85,2,335,60.58 %
Pittsburgh Ward 32 Dist 4,340,131,58,2,191,56.18 %
Pittsburgh Ward 32 Dist 5,569,272,110,5,387,68.01 %
Pittsburgh Ward 32 Dist 6,617,281,99,3,383,62.07 %
Pittsburgh Ward 32 Dist 7,591,275,92,2,369,62.44 %
Pittsburgh Ward 32 Dist 8,639,301,125,3,429,67.14 %
Pleasant Hl Dist 1,706,343,106,5,454,64.31 %
Pleasant Hl Dist 2,565,301,89,6,396,70.09 %
Pleasant Hl Dist 3,583,306,115,1,422,72.38 %
Pleasant Hl Dist 4,541,282,89,3,374,69.13 %
Pleasant Hl Dist 5,689,294,146,3,443,64.30 %
Pleasant Hl Dist 6,988,537,167,6,710,71.86 %
Pleasant Hl Dist 7,536,284,77,0,361,67.35 %
Pleasant Hl Dist 8,534,293,67,5,365,68.35 %
Pleasant Hl Dist 9,658,354,112,6,472,71.73 %
Pleasant Hl Dist 10,503,259,82,3,344,68.39 %
Plum Dist 1,1805,827,373,21,1221,67.65 %
Plum Dist 2,632,312,87,4,403,63.77 %
Plum Dist 3,1030,454,257,16,727,70.58 %
Plum Dist 4,842,446,136,3,585,69.48 %
Plum Dist 5,878,433,130,3,566,64.46 %
Plum Dist 6,1285,732,181,11,924,71.91 %
Plum Dist 7,1245,606,232,3,841,67.55 %
Plum Dist 8,594,302,106,4,412,69.36 %
Plum Dist 9,1137,546,278,8,832,73.18 %
Plum Dist 10,608,298,93,0,391,64.31 %
Plum Dist 11,813,431,136,2,569,69.99 %
Plum Dist 12,1139,613,208,11,832,73.05 %
Plum Dist 13,567,299,94,1,394,69.49 %
Plum Dist 14,746,306,114,4,424,56.84 %
Plum Dist 15,890,365,123,7,495,55.62 %
Plum Dist 16,610,307,105,0,412,67.54 %
Plum Dist 17,688,323,97,8,428,62.21 %
Plum Dist 18,820,436,152,2,590,71.95 %
Plum Dist 19,2085,1034,355,14,1403,67.29 %
Plum Dist 20,989,467,144,6,617,62.39 %
Plum Dist 21,430,241,49,1,291,67.67 %
Port Vue Dist 1,575,227,58,3,288,50.09 %
Port Vue Dist 2,508,225,58,5,288,56.69 %
Port Vue Dist 3,513,288,76,2,366,71.35 %
Port Vue Dist 4,692,359,75,7,441,63.73 %
Rankin Ward 1,341,16,40,5,61,17.89 %
Rankin Ward 2,402,145,32,5,182,45.27 %
Rankin Ward 3,430,101,30,4,135,31.40 %
Reserve Ward 1,529,288,66,4,358,67.67 %
Reserve Ward 2,557,306,90,4,400,71.81 %
Reserve Ward 3,537,268,104,11,383,71.32 %
Reserve Ward 4,830,398,170,4,572,68.92 %
Richland Dist 1,1215,646,210,5,861,70.86 %
Richland Dist 2,1199,577,201,13,791,65.97 %
Richland Dist 3,1166,613,186,7,806,69.13 %
Richland Dist 4,1156,641,193,11,845,73.10 %
Richland Dist 5,1059,520,193,9,722,68.18 %
Richland Dist 6,1128,601,215,6,822,72.87 %
Richland Dist 7,1174,694,151,4,849,72.32 %
Richland Dist 8,924,423,198,3,624,67.53 %
Robinson Dist 1,1668,702,439,12,1153,69.12 %
Robinson Dist 2,1212,621,241,12,874,72.11 %
Robinson Dist 3,706,360,116,5,481,68.13 %
Robinson Dist 4,984,450,211,2,663,67.38 %
Robinson Dist 5,605,284,158,3,445,73.55 %
Robinson Dist 6,887,367,142,11,520,58.62 %
Robinson Dist 7,1394,721,302,7,1030,73.89 %
Robinson Dist 8,1794,720,297,26,1043,58.14 %
Robinson Dist 9,2556,1083,496,21,1600,62.60 %
Ross Ward 1 Dist 1,746,420,120,3,543,72.79 %
Ross Ward 1 Dist 2,626,280,162,6,448,71.57 %
Ross Ward 1 Dist 3,507,237,90,8,335,66.07 %
Ross Ward 1 Dist 4,842,464,143,4,611,72.57 %
Ross Ward 2 Dist 1,1265,559,256,4,819,64.74 %
Ross Ward 2 Dist 2,924,500,197,5,702,75.97 %
Ross Ward 2 Dist 3,708,382,140,6,528,74.58 %
Ross Ward 3 Dist 1,685,359,122,2,483,70.51 %
Ross Ward 3 Dist 2,717,369,167,3,539,75.17 %
Ross Ward 3 Dist 3,563,290,89,4,383,68.03 %
Ross Ward 3 Dist 4,683,364,121,5,490,71.74 %
Ross Ward 4 Dist 1,867,446,164,4,614,70.82 %
Ross Ward 4 Dist 2,1062,529,207,7,743,69.96 %
Ross Ward 4 Dist 3,714,373,157,2,532,74.51 %
Ross Ward 4 Dist 4,785,375,164,3,542,69.04 %
Ross Ward 5 Dist 1,612,329,120,0,449,73.37 %
Ross Ward 5 Dist 2,417,214,77,2,293,70.26 %
Ross Ward 5 Dist 3,779,310,198,1,509,65.34 %
Ross Ward 5 Dist 4,759,403,144,8,555,73.12 %
Ross Ward 6 Dist 1,488,252,89,7,348,71.31 %
Ross Ward 6 Dist 2,990,463,192,3,658,66.46 %
Ross Ward 6 Dist 3,670,349,90,7,446,66.57 %
Ross Ward 6 Dist 4,603,314,75,4,393,65.17 %
Ross Ward 7 Dist 1,595,295,112,0,407,68.40 %
Ross Ward 7 Dist 2,607,242,81,2,325,53.54 %
Ross Ward 7 Dist 3,719,332,166,2,500,69.54 %
Ross Ward 7 Dist 4,600,296,93,6,395,65.83 %
Ross Ward 8 Dist 1,1610,631,359,20,1010,62.73 %
Ross Ward 8 Dist 2,509,208,102,5,315,61.89 %
Ross Ward 8 Dist 3,563,294,133,5,432,76.73 %
Ross Ward 9 Dist 1,821,480,152,2,634,77.22 %
Ross Ward 9 Dist 2,970,513,172,5,690,71.13 %
Ross Ward 9 Dist 3,785,410,149,2,561,71.46 %
Rosslyn Farms,417,252,57,3,312,74.82 %
Scott Ward 1 Dist 1,577,248,57,2,307,53.21 %
Scott Ward 1 Dist 2,659,252,64,9,325,49.32 %
Scott Ward 2 Dist 1,475,205,112,1,318,66.95 %
Scott Ward 2 Dist 2,658,364,94,3,461,70.06 %
Scott Ward 3 Dist 1,524,265,104,5,374,71.37 %
Scott Ward 3 Dist 2,691,324,128,5,457,66.14 %
Scott Ward 4 Dist 1,763,375,175,4,554,72.61 %
Scott Ward 4 Dist 2,624,318,148,3,469,75.16 %
Scott Ward 5 Dist 1,601,290,81,4,375,62.40 %
Scott Ward 5 Dist 2,708,344,162,7,513,72.46 %
Scott Ward 6 Dist 1,648,280,108,11,399,61.57 %
Scott Ward 6 Dist 2,808,407,152,8,567,70.17 %
Scott Ward 7 Dist 1,924,390,249,3,642,69.48 %
Scott Ward 7 Dist 2,634,329,146,4,479,75.55 %
Scott Ward 8 Dist 1,513,275,114,0,389,75.83 %
Scott Ward 8 Dist 2,1068,425,343,9,777,72.75 %
Scott Ward 9 Dist 1,350,136,51,5,192,54.86 %
Scott Ward 9 Dist 2,342,164,54,0,218,63.74 %
Sewickley Ward 1,958,455,166,4,625,65.24 %
Sewickley Ward 2 Dist 1,553,237,95,3,335,60.58 %
Sewickley Ward 2 Dist 2,592,270,114,6,390,65.88 %
Sewickley Ward 3,1042,478,187,12,677,64.97 %
Sewickley Hts,786,390,124,3,517,65.78 %
Sewickley Hills,578,336,80,6,422,73.01 %
Shaler Ward 1 Dist 1,522,289,105,0,394,75.48 %
Shaler Ward 1 Dist 2,528,277,87,6,370,70.08 %
Shaler Ward 1 Dist 3,561,262,81,4,347,61.85 %
Shaler Ward 1 Dist 4,598,317,133,3,453,75.75 %
Shaler Ward 1 Dist 5,650,295,104,7,406,62.46 %
Shaler Ward 2 Dist 1,1050,566,205,1,772,73.52 %
Shaler Ward 2 Dist 2,762,429,135,2,566,74.28 %
Shaler Ward 2 Dist 3,607,297,95,3,395,65.07 %
Shaler Ward 2 Dist 4,777,447,130,5,582,74.90 %
Shaler Ward 2 Dist 5,368,186,65,7,258,70.11 %
Shaler Ward 3 Dist 1,604,329,124,5,458,75.83 %
Shaler Ward 3 Dist 2,594,347,103,3,453,76.26 %
Shaler Ward 3 Dist 3,586,330,89,3,422,72.01 %
Shaler Ward 3 Dist 4,723,423,120,6,549,75.93 %
Shaler Ward 3 Dist 5,669,352,142,2,496,74.14 %
Shaler Ward 4 Dist 1,836,453,139,3,595,71.17 %
Shaler Ward 4 Dist 2,467,235,76,3,314,67.24 %
Shaler Ward 4 Dist 3,650,356,129,5,490,75.38 %
Shaler Ward 4 Dist 4,649,350,129,3,482,74.27 %
Shaler Ward 4 Dist 5,506,259,106,2,367,72.53 %
Shaler Ward 5 Dist 1,757,459,123,6,588,77.68 %
Shaler Ward 5 Dist 2,679,397,108,7,512,75.41 %
Shaler Ward 5 Dist 3,557,278,139,4,421,75.58 %
Shaler Ward 5 Dist 4,363,199,64,1,264,72.73 %
Shaler Ward 5 Dist 5,787,407,138,1,546,69.38 %
Shaler Ward 6 Dist 1,642,345,121,5,471,73.36 %
Shaler Ward 6 Dist 2,710,405,96,3,504,70.99 %
Shaler Ward 6 Dist 3,553,342,95,4,441,79.75 %
Shaler Ward 6 Dist 4,334,182,75,0,257,76.95 %
Shaler Ward 6 Dist 5,543,303,103,1,407,74.95 %
Shaler Ward 7 Dist 1,592,292,126,2,420,70.95 %
Shaler Ward 7 Dist 2,770,400,107,7,514,66.75 %
Shaler Ward 7 Dist 3,644,306,103,8,417,64.75 %
Shaler Ward 7 Dist 4,1019,523,195,5,723,70.95 %
Sharpsburg Dist 1,593,227,80,5,312,52.61 %
Sharpsburg Dist 2,834,324,98,8,430,51.56 %
Sharpsburg Dist 3,852,371,102,7,480,56.34 %
S Fayette Dist 1,586,303,126,4,433,73.89 %
S Fayette Dist 2,1147,600,170,4,774,67.48 %
S Fayette Dist 3,1866,902,305,14,1221,65.43 %
S Fayette Dist 4,884,426,139,3,568,64.25 %
S Fayette Dist 5,990,505,137,6,648,65.45 %
S Fayette Dist 6,1273,614,184,14,812,63.79 %
S Fayette Dist 7,695,312,126,5,443,63.74 %
S Fayette Dist 8,1547,796,291,8,1095,70.78 %
S Fayette Dist 9,666,271,92,4,367,55.11 %
S Fayette Dist 10,775,395,130,9,534,68.90 %
S Fayette Dist 11,1093,521,157,9,687,62.85 %
S Fayette Dist 12,863,420,184,5,609,70.57 %
South Park Dist 1,772,428,104,7,539,69.82 %
South Park Dist 2,783,396,137,4,537,68.58 %
South Park Dist 3,668,334,100,4,438,65.57 %
South Park Dist 4,833,412,119,10,541,64.95 %
South Park Dist 5,739,414,98,2,514,69.55 %
South Park Dist 6,928,430,140,13,583,62.82 %
South Park Dist 7,1097,503,220,10,733,66.82 %
South Park Dist 8,513,292,82,2,376,73.29 %
South Park Dist 9,857,389,159,2,550,64.18 %
South Park Dist 10,865,461,131,9,601,69.48 %
South Park Dist 11,569,263,72,9,344,60.46 %
South Park Dist 12,595,310,114,2,426,71.60 %
South Park Dist 13,1081,574,161,7,742,68.64 %
S Versailles,217,137,24,3,164,75.58 %
Springdale Br Dist 1,690,318,87,9,414,60.00 %
Springdale Br Dist 2,597,325,93,3,421,70.52 %
Springdale Br Dist 3,545,256,76,1,333,61.10 %
Springdale Br Dist 4,465,220,59,3,282,60.65 %
Springdale Twp,1187,614,197,18,829,69.84 %
Stowe Ward 1,434,138,42,2,182,41.94 %
Stowe Ward 2 Dist 1,174,51,18,0,69,39.66 %
Stowe Ward 2 Dist 2,678,237,95,8,340,50.15 %
Stowe Ward 3,351,119,39,4,162,46.15 %
Stowe Ward 4 Dist 1,342,142,62,2,206,60.23 %
Stowe Ward 4 Dist 2,372,164,92,2,258,69.35 %
Stowe Ward 5,438,132,51,0,183,41.78 %
Stowe Ward 6,445,115,57,0,172,38.65 %
Stowe Ward 7,301,70,13,2,85,28.24 %
Stowe Ward 8,402,93,19,1,113,28.11 %
Stowe Ward 9,290,71,30,5,106,36.55 %
Swissvale Dist 1,849,256,130,7,393,46.29 %
Swissvale Dist 2,746,267,106,6,379,50.80 %
Swissvale Dist 3,662,226,104,6,336,50.76 %
Swissvale Dist 4,612,240,106,6,352,57.52 %
Swissvale Dist 5,758,293,172,8,473,62.40 %
Swissvale Dist 6,390,134,43,1,178,45.64 %
Swissvale Dist 7,681,330,126,7,463,67.99 %
Swissvale Dist 8,728,291,135,6,432,59.34 %
Swissvale Dist 9,689,289,120,10,419,60.81 %
Swissvale Dist 10,247,79,24,3,106,42.91 %
Swissvale Dist 11,698,333,186,8,527,75.50 %
Tarentum Ward 1 Dist 1,662,254,44,6,304,45.92 %
Tarentum Ward 1 Dist 2,466,250,55,1,306,65.67 %
Tarentum Ward 2,529,190,69,2,261,49.34 %
Tarentum Ward 3 Dist 1,282,106,25,1,132,46.81 %
Tarentum Ward 3 Dist 2,572,233,42,3,278,48.60 %
Thornburg,404,257,62,3,322,79.70 %
Pennsbury Vill,593,314,72,3,389,65.60 %
Trafford,57,27,8,1,36,63.16 %
Turtle Creek Ward 1 Dist 1,836,350,131,8,489,58.49 %
Turtle Creek Ward 1 Dist 2,429,160,40,5,205,47.79 %
Turtle Creek Ward 2 Dist 1,705,220,86,10,316,44.82 %
Turtle Creek Ward 2 Dist 2,299,101,31,2,134,44.82 %
Turtle Creek Ward 3 Dist 1,564,194,54,0,248,43.97 %
Turtle Creek Ward 3 Dist 2,456,178,67,3,248,54.39 %
Up St Clair Ward 1 Dist 1,727,370,134,6,510,70.15 %
Up St Clair Ward 1 Dist 2,824,422,166,5,593,71.97 %
Up St Clair Ward 1 Dist 3,1153,637,211,5,853,73.98 %
Up St Clair Ward 1 Dist 4,834,416,160,2,578,69.30 %
Up St Clair Ward 2 Dist 1,1016,524,176,3,703,69.19 %
Up St Clair Ward 2 Dist 2,722,384,120,5,509,70.50 %
Up St Clair Ward 2 Dist 3,1051,506,214,14,734,69.84 %
Up St Clair Ward 2 Dist 4,546,289,114,1,404,73.99 %
Up St Clair Ward 3 Dist 1,1027,528,180,4,712,69.33 %
Up St Clair Ward 3 Dist 2,862,460,154,4,618,71.69 %
Up St Clair Ward 3 Dist 3,1209,580,253,5,838,69.31 %
Up St Clair Ward 4 Dist 1,1042,553,184,6,743,71.31 %
Up St Clair Ward 4 Dist 2,780,400,130,4,534,68.46 %
Up St Clair Ward 4 Dist 3,641,348,113,2,463,72.23 %
Up St Clair Ward 4 Dist 4,1115,481,251,15,747,67.00 %
Up St Clair Ward 5 Dist 1,1348,721,230,3,954,70.77 %
Up St Clair Ward 5 Dist 2,833,482,134,3,619,74.31 %
Up St Clair Ward 5 Dist 3,900,479,167,1,647,71.89 %
Verona Dist 1,518,223,49,1,273,52.70 %
Verona Dist 2,591,302,66,5,373,63.11 %
Verona Dist 3,594,288,75,3,366,61.62 %
Versailles Dist 1,545,216,65,3,284,52.11 %
Versailles Dist 2,447,164,67,0,231,51.68 %
Wall,297,99,31,1,131,44.11 %
West Deer Dist 1,1490,808,221,7,1036,69.53 %
West Deer Dist 2,615,354,70,2,426,69.27 %
West Deer Dist 3,815,382,119,4,505,61.96 %
West Deer Dist 4,839,430,182,6,618,73.66 %
West Deer Dist 5,884,490,84,7,581,65.72 %
West Deer Dist 6,772,432,99,11,542,70.21 %
West Deer Dist 7,1804,874,414,15,1303,72.23 %
West Deer Dist 8,1566,752,417,8,1177,75.16 %
W Elizabeth,249,126,11,4,141,56.63 %
W Homestead Dist 1,416,144,29,7,180,43.27 %
W Homestead Dist 2,463,269,83,3,355,76.67 %
W Homestead Dist 3,518,286,78,1,365,70.46 %
West Mifflin Dist 1,695,312,111,1,424,61.01 %
West Mifflin Dist 2,469,180,85,3,268,57.14 %
West Mifflin Dist 3,475,227,67,6,300,63.16 %
West Mifflin Dist 4,444,71,12,2,85,19.14 %
West Mifflin Dist 5,831,455,117,1,573,68.95 %
West Mifflin Dist 6,322,150,54,0,204,63.35 %
West Mifflin Dist 7,762,397,90,2,489,64.17 %
West Mifflin Dist 8,578,231,72,2,305,52.77 %
West Mifflin Dist 9,781,323,144,12,479,61.33 %
West Mifflin Dist 10,512,259,81,1,341,66.60 %
West Mifflin Dist 11,781,310,127,5,442,56.59 %
West Mifflin Dist 12,1002,393,163,2,558,55.69 %
West Mifflin Dist 13,543,218,89,1,308,56.72 %
West Mifflin Dist 14,883,476,135,5,616,69.76 %
West Mifflin Dist 15,595,294,110,4,408,68.57 %
West Mifflin Dist 16,1169,548,300,2,850,72.71 %
West Mifflin Dist 17,583,304,91,3,398,68.27 %
West Mifflin Dist 18,810,362,152,10,524,64.69 %
West Mifflin Dist 19,637,321,120,4,445,69.86 %
West Mifflin Dist 20,453,230,104,1,335,73.95 %
West Mifflin Dist 21,681,278,152,5,435,63.88 %
West View Dist 1,663,343,103,3,449,67.72 %
West View Dist 2,743,367,90,3,460,61.91 %
West View Dist 3,588,276,88,8,372,63.27 %
West View Dist 4,582,303,90,4,397,68.21 %
West View Dist 5,787,360,153,9,522,66.33 %
West View Dist 6,720,404,122,3,529,73.47 %
West View Dist 7,642,328,137,4,469,73.05 %
Whitaker Dist 1,432,214,47,4,265,61.34 %
Whitaker Dist 2,354,137,53,0,190,53.67 %
Whitehall Dist 1,551,272,117,3,392,71.14 %
Whitehall Dist 2,600,303,101,3,407,67.83 %
Whitehall Dist 3,740,396,122,7,525,70.95 %
Whitehall Dist 4,657,366,117,5,488,74.28 %
Whitehall Dist 5,704,331,134,14,479,68.04 %
Whitehall Dist 6,1046,179,104,22,305,29.16 %
Whitehall Dist 7,465,220,91,13,324,69.68 %
Whitehall Dist 8,794,441,142,3,586,73.80 %
Whitehall Dist 9,578,280,116,5,401,69.38 %
Whitehall Dist 10,634,320,116,5,441,69.56 %
Whitehall Dist 11,633,363,105,6,474,74.88 %
Whitehall Dist 12,586,297,90,3,390,66.55 %
Whitehall Dist 13,650,317,188,4,509,78.31 %
Whitehall Dist 14,607,295,124,5,424,69.85 %
Whitehall Dist 15,1008,477,261,0,738,73.21 %
Whitehall Dist 16,620,319,129,2,450,72.58 %
White Oak Dist 1,724,325,97,2,424,58.56 %
White Oak Dist 2,794,346,122,4,472,59.45 %
White Oak Dist 3,885,430,153,2,585,66.10 %
White Oak Dist 4,732,378,148,0,526,71.86 %
White Oak Dist 5,806,409,136,4,549,68.11 %
White Oak Dist 6,728,359,133,5,497,68.27 %
White Oak Dist 7,1091,495,203,12,710,65.08 %
Wilkins Ward 1 Dist 1,777,345,104,10,459,59.07 %
Wilkins Ward 1 Dist 2,659,347,122,6,475,72.08 %
Wilkins Ward 1 Dist 3,844,407,179,8,594,70.38 %
Wilkins Ward 1 Dist 4,662,337,104,9,450,67.98 %
Wilkins Ward 1 Dist 5,481,165,88,11,264,54.89 %
Wilkins Ward 2 Dist 1,642,331,105,5,441,68.69 %
Wilkins Ward 2 Dist 2,931,388,168,8,564,60.58 %
Wilkinsburg Ward 1 Dist 1,929,246,133,13,392,42.20 %
Wilkinsburg Ward 1 Dist 2,693,184,71,3,258,37.23 %
Wilkinsburg Ward 1 Dist 3,437,104,50,5,159,36.38 %
Wilkinsburg Ward 1 Dist 4,624,248,128,6,382,61.22 %
Wilkinsburg Ward 1 Dist 5,544,217,133,3,353,64.89 %
Wilkinsburg Ward 1 Dist 6,978,238,188,13,439,44.89 %
Wilkinsburg Ward 2 Dist 1,760,201,154,7,362,47.63 %
Wilkinsburg Ward 2 Dist 2,999,379,218,1,598,59.86 %
Wilkinsburg Ward 2 Dist 3,754,177,89,4,270,35.81 %
Wilkinsburg Ward 2 Dist 4,527,125,40,5,170,32.26 %
Wilkinsburg Ward 2 Dist 5,813,222,117,7,346,42.56 %
Wilkinsburg Ward 3 Dist 1,755,360,169,5,534,70.73 %
Wilkinsburg Ward 3 Dist 2,698,318,117,10,445,63.75 %
Wilkinsburg Ward 3 Dist 3,817,220,74,13,307,37.58 %
Wilkinsburg Ward 3 Dist 4,1054,379,189,13,581,55.12 %
Wilkinsburg Ward 3 Dist 5,1023,318,147,8,473,46.24 %
Wilkinsburg Ward 3 Dist 6,525,153,42,6,201,38.29 %
Wilmerding Dist 1,481,102,48,2,152,31.60 %
Wilmerding Dist 2,674,225,76,7,308,45.70 %
Total:,939390,408702,161580,7192,577474,61.47 %