County,Registered Voters,Election Day,Absentee,Provisional,Ballots Cast,Voter Turnout
ALEPPO,1388,523,582,16,1121,80.76 %
ASPINWALL DIST 1,861,397,310,18,725,84.20 %
ASPINWALL DIST 2,572,257,207,12,476,83.22 %
ASPINWALL DIST 3,856,361,335,11,707,82.59 %
AVALON WARD 1,1108,457,341,33,831,75.00 %
AVALON WARD 2 DIST 1,717,307,250,17,574,80.06 %
AVALON WARD 2 DIST 2,487,178,203,4,385,79.06 %
AVALON WARD 3 DIST 1,320,140,119,0,259,80.94 %
AVALON WARD 3 DIST 2,454,175,172,5,352,77.53 %
AVALON WARD 3 DIST 3,507,159,221,6,386,76.13 %
BALDWIN BR DIST 1,626,288,204,24,516,82.43 %
BALDWIN BR DIST 2,1024,466,401,23,890,86.91 %
BALDWIN BR DIST 3,838,369,293,23,685,81.74 %
BALDWIN BR DIST 4,782,396,243,17,656,83.89 %
BALDWIN BR DIST 5,824,359,301,17,677,82.16 %
BALDWIN BR DIST 6,764,350,282,0,632,82.72 %
BALDWIN BR DIST 7,820,349,321,11,681,83.05 %
BALDWIN BR DIST 8,715,318,296,6,620,86.71 %
BALDWIN BR DIST 9,769,286,348,25,659,85.70 %
BALDWIN BR DIST 10,1067,304,335,13,652,61.11 %
BALDWIN BR DIST 11,1294,397,468,9,874,67.54 %
BALDWIN BR DIST 12,634,296,221,12,529,83.44 %
BALDWIN BR DIST 13,688,334,279,6,619,89.97 %
BALDWIN BR DIST 14,613,282,228,20,530,86.46 %
BALDWIN BR DIST 15,798,355,317,3,675,84.59 %
BALDWIN BR DIST 16,914,432,320,9,761,83.26 %
BALDWIN BR DIST 17,677,282,298,9,589,87.00 %
BALDWIN BR DIST 18,938,331,429,12,772,82.30 %
BALDWIN TP DIST 1,806,452,243,7,702,87.10 %
BALDWIN TP DIST 2,757,360,254,13,627,82.83 %
BELL ACRES,1205,617,379,21,1017,84.40 %
BELLEVUE WARD 1 DIST 1,970,340,345,18,703,72.47 %
BELLEVUE WARD 1 DIST 2,987,378,352,14,744,75.38 %
BELLEVUE WARD 2 DIST 1,1146,423,383,16,822,71.73 %
BELLEVUE WARD 2 DIST 2,1010,401,337,20,758,75.05 %
BELLEVUE WARD 3 DIST 1,1040,404,361,11,776,74.62 %
BELLEVUE WARD 3 DIST 2,1019,433,345,18,796,78.12 %
BEN AVON DIST 1,479,252,161,4,417,87.06 %
BEN AVON DIST 2,986,458,366,22,846,85.80 %
BEN AVON HT,337,205,91,5,301,89.32 %
BETHEL PARK WARD 1 DIST 1,883,397,333,12,742,84.03 %
BETHEL PARK WARD 1 DIST 2,783,369,299,8,676,86.33 %
BETHEL PARK WARD 1 DIST 3,848,381,334,12,727,85.73 %
BETHEL PARK WARD 2 DIST 1,743,347,283,12,642,86.41 %
BETHEL PARK WARD 2 DIST 2,950,428,378,16,822,86.53 %
BETHEL PARK WARD 2 DIST 3,1121,485,440,14,939,83.76 %
BETHEL PARK WARD 3 DIST 1,809,394,298,17,709,87.64 %
BETHEL PARK WARD 3 DIST 2,1100,465,484,11,960,87.27 %
BETHEL PARK WARD 3 DIST 3,1094,455,503,22,980,89.58 %
BETHEL PARK WARD 4 DIST 1,1328,588,529,19,1136,85.54 %
BETHEL PARK WARD 4 DIST 2,800,303,347,12,662,82.75 %
BETHEL PARK WARD 4 DIST 3,910,396,358,11,765,84.07 %
BETHEL PARK WARD 5 DIST 1,714,319,275,18,612,85.71 %
BETHEL PARK WARD 5 DIST 2,679,313,217,10,540,79.53 %
BETHEL PARK WARD 5 DIST 3,1499,500,696,30,1226,81.79 %
BETHEL PARK WARD 6 DIST 1,1320,598,488,20,1106,83.79 %
BETHEL PARK WARD 6 DIST 2,960,440,395,9,844,87.92 %
BETHEL PARK WARD 6 DIST 3,879,342,400,20,762,86.69 %
BETHEL PARK WARD 7 DIST 1,1214,581,471,14,1066,87.81 %
BETHEL PARK WARD 7 DIST 2,1269,533,518,18,1069,84.24 %
BETHEL PARK WARD 7 DIST 3,775,350,313,15,678,87.48 %
BETHEL PARK WARD 8 DIST 1,562,263,220,1,484,86.12 %
BETHEL PARK WARD 8 DIST 2,497,105,236,6,347,69.82 %
BETHEL PARK WARD 8 DIST 3,1274,569,511,20,1100,86.34 %
BETHEL PARK WARD 8 DIST 4,461,223,177,4,404,87.64 %
BETHEL PARK WARD 9 DIST 1,589,277,237,7,521,88.46 %
BETHEL PARK WARD 9 DIST 2,736,310,290,11,611,83.02 %
BETHEL PARK WARD 9 DIST 3,1414,587,634,24,1245,88.05 %
BLAWNOX,1042,455,307,25,787,75.53 %
BRACKENRIDGE WARD 1,507,244,94,9,347,68.44 %
BRACKENRIDGE WARD 2,782,406,187,11,604,77.24 %
BRACKENRIDGE WARD 3,662,329,149,10,488,73.72 %
BRADDOCK WARD 1,490,148,125,14,287,58.57 %
BRADDOCK WARD 2,614,192,167,8,367,59.77 %
BRADDOCK WARD 3,453,139,81,1,221,48.79 %
BRADDOCK HL DIST 1,810,267,282,11,560,69.14 %
BRADDOCK HL DIST 2,543,224,191,26,441,81.22 %
BRADFORD WOODS,1018,456,405,0,861,84.58 %
BRENTWOOD DIST 1,539,249,204,7,460,85.34 %
BRENTWOOD DIST 2,744,330,239,7,576,77.42 %
BRENTWOOD DIST 3,613,273,194,20,487,79.45 %
BRENTWOOD DIST 4,820,380,270,15,665,81.10 %
BRENTWOOD DIST 5,733,287,230,11,528,72.03 %
BRENTWOOD DIST 6,694,252,230,5,487,70.17 %
BRENTWOOD DIST 7,763,338,252,16,606,79.42 %
BRENTWOOD DIST 8,728,265,333,14,612,84.07 %
BRENTWOOD DIST 9,607,253,218,10,481,79.24 %
BRENTWOOD DIST 10,558,255,191,12,458,82.08 %
BRIDGEVILLE DIST 1,830,408,216,27,651,78.43 %
BRIDGEVILLE DIST 2,857,410,235,8,653,76.20 %
BRIDGEVILLE DIST 3,877,421,286,28,735,83.81 %
BRIDGEVILLE DIST 4,1010,478,328,25,831,82.28 %
CARNEGIE WARD 1 DIST 1,547,248,143,16,407,74.41 %
CARNEGIE WARD 1 DIST 2,1225,519,416,25,960,78.37 %
CARNEGIE WARD 1 DIST 3,887,404,300,16,720,81.17 %
CARNEGIE WARD 1 DIST 4,388,138,116,10,264,68.04 %
CARNEGIE WARD 2 DIST 1,672,295,179,21,495,73.66 %
CARNEGIE WARD 2 DIST 2,506,209,173,13,395,78.06 %
CARNEGIE WARD 2 DIST 3,511,204,229,8,441,86.30 %
CARNEGIE WARD 2 DIST 4,904,324,267,12,603,66.70 %
CASL SHANNON DIST 1,1072,369,393,6,768,71.64 %
CASL SHANNON DIST 2,846,388,269,16,673,79.55 %
CASL SHANNON DIST 3,844,374,303,17,694,82.23 %
CASL SHANNON DIST 4,648,260,251,7,518,79.94 %
CASL SHANNON DIST 5,732,334,266,17,617,84.29 %
CASL SHANNON DIST 6,661,295,249,16,560,84.72 %
CASL SHANNON DIST 7,771,365,265,10,640,83.01 %
CASL SHANNON DIST 8,569,257,218,14,489,85.94 %
CHALFANT DIST 1,588,259,178,17,454,77.21 %
CHESWICK DIST 1,648,353,196,11,560,86.42 %
CHESWICK DIST 2,669,368,209,7,584,87.29 %
CHURCHILL DIST 1,712,270,360,14,644,90.45 %
CHURCHILL DIST 2,741,267,334,4,605,81.65 %
CHURCHILL DIST 3,656,261,316,10,587,89.48 %
CHURCHILL DIST 4,704,257,326,9,592,84.09 %
CLAIRTON WARD 1 DIST 1,398,141,92,12,245,61.56 %
CLAIRTON WARD 1 DIST 2,401,162,118,10,290,72.32 %
CLAIRTON WARD 1 DIST 3,336,142,83,6,231,68.75 %
CLAIRTON WARD 2 DIST 1,113,42,26,0,68,60.18 %
CLAIRTON WARD 2 DIST 2,298,90,87,8,185,62.08 %
CLAIRTON WARD 2 DIST 3,437,151,103,2,256,58.58 %
CLAIRTON WARD 3 DIST 1,443,172,133,5,310,69.98 %
CLAIRTON WARD 3 DIST 2,365,141,93,6,240,65.75 %
CLAIRTON WARD 3 DIST 3,400,127,86,15,228,57.00 %
CLAIRTON WARD 4 DIST 1,373,107,111,10,228,61.13 %
CLAIRTON WARD 4 DIST 2,355,130,81,3,214,60.28 %
CLAIRTON WARD 4 DIST 3,451,194,125,10,329,72.95 %
COLLIER DIST 1,1318,630,490,22,1142,86.65 %
COLLIER DIST 2,1353,748,407,28,1183,87.44 %
COLLIER DIST 3,1303,525,550,13,1088,83.50 %
COLLIER DIST 4,775,324,299,23,646,83.35 %
COLLIER DIST 5,987,449,370,17,836,84.70 %
COLLIER DIST 6,1146,516,408,32,956,83.42 %
CORAOPOLIS WARD 1 DIST 1,437,212,109,8,329,75.29 %
CORAOPOLIS WARD 1 DIST 2,513,226,161,3,390,76.02 %
CORAOPOLIS WARD 2,832,288,263,14,565,67.91 %
CORAOPOLIS WARD 3 DIST 1,588,273,178,5,456,77.55 %
CORAOPOLIS WARD 3 DIST 2,578,274,164,15,453,78.37 %
CORAOPOLIS WARD 4 DIST 1,456,216,131,7,354,77.63 %
CORAOPOLIS WARD 4 DIST 2,538,249,175,8,432,80.30 %
CRAFTON WARD 1 DIST 1,932,387,319,6,712,76.39 %
CRAFTON WARD 1 DIST 2,661,296,208,17,521,78.82 %
CRAFTON WARD 2 DIST 1,621,281,220,14,515,82.93 %
CRAFTON WARD 2 DIST 2,808,317,280,13,610,75.50 %
CRAFTON WARD 3 DIST 1,994,477,331,11,819,82.39 %
CRAFTON WARD 3 DIST 2,625,313,192,6,511,81.76 %
CRESCENT WARD 1,1101,561,295,38,894,81.20 %
CRESCENT WARD 2,685,361,173,5,539,78.69 %
DORMONT DIST 1,718,277,269,17,563,78.41 %
DORMONT DIST 2,535,216,241,9,466,87.10 %
DORMONT DIST 3,941,312,385,22,719,76.41 %
DORMONT DIST 4,673,259,285,16,560,83.21 %
DORMONT DIST 5,1098,373,461,15,849,77.32 %
DORMONT DIST 6,534,221,211,6,438,82.02 %
DORMONT DIST 7,527,193,234,10,437,82.92 %
DORMONT DIST 8,424,165,182,4,351,82.78 %
DORMONT DIST 9,548,213,217,17,447,81.57 %
DORMONT DIST 10,639,264,274,6,544,85.13 %
DRAVOSBURG DIST 1,541,223,156,27,406,75.05 %
DRAVOSBURG DIST 2,341,170,103,6,279,81.82 %
DRAVOSBURG DIST 3,266,129,78,5,212,79.70 %
DUQUESNE WARD 1 DIST 1,446,182,133,15,330,73.99 %
DUQUESNE WARD 1 DIST 2,530,161,105,4,270,50.94 %
DUQUESNE WARD 1 DIST 3,322,88,58,11,157,48.76 %
DUQUESNE WARD 1 DIST 4,209,54,42,2,98,46.89 %
DUQUESNE WARD 2 DIST 1,348,111,80,9,200,57.47 %
DUQUESNE WARD 2 DIST 2,377,134,80,12,226,59.95 %
DUQUESNE WARD 2 DIST 3,431,170,87,11,268,62.18 %
DUQUESNE WARD 3 DIST 1,236,86,50,9,145,61.44 %
DUQUESNE WARD 3 DIST 2,171,61,37,3,101,59.06 %
DUQUESNE WARD 3 DIST 3,556,203,147,8,358,64.39 %
EAST DEER WARD 1,332,178,76,14,268,80.72 %
EAST DEER WARD 2,574,296,146,12,454,79.09 %
E MCKEESPORT DIST 1,411,184,119,13,316,76.89 %
E MCKEESPORT DIST 2,524,261,131,16,408,77.86 %
E MCKEESPORT DIST 3,482,238,102,20,360,74.69 %
E PITTSBURGH WARD 1,356,138,75,7,220,61.80 %
E PITTSBURGH WARD 2,405,177,56,9,242,59.75 %
E PITTSBURGH WARD 3,530,153,114,21,288,54.34 %
EDGEWOOD DIST 1,1030,304,527,10,841,81.65 %
EDGEWOOD DIST 2,965,290,510,7,807,83.63 %
EDGEWOOD DIST 3,894,200,527,3,730,81.66 %
EDGEWORTH DIST 1,695,299,241,10,550,79.14 %
EDGEWORTH DIST 2,763,352,290,14,656,85.98 %
ELIZABETH BR,894,459,208,16,683,76.40 %
ELIZABETH TP WARD 1 DIST 1,562,286,179,6,471,83.81 %
ELIZABETH TP WARD 1 DIST 2,945,500,286,26,812,85.93 %
ELIZABETH TP WARD 2,1304,669,408,23,1100,84.36 %
ELIZABETH TP WARD 3,1360,711,444,3,1158,85.15 %
ELIZABETH TP WARD 4 DIST 1,926,434,313,18,765,82.61 %
ELIZABETH TP WARD 4 DIST 2,463,222,161,6,389,84.02 %
ELIZABETH TP WARD 5 DIST 1,463,236,121,10,367,79.27 %
ELIZABETH TP WARD 5 DIST 2,818,404,229,11,644,78.73 %
ELIZABETH TP WARD 6 DIST 1,606,332,179,9,520,85.81 %
ELIZABETH TP WARD 6 DIST 2,731,408,184,9,601,82.22 %
ELIZABETH TP WARD 7,1293,653,435,13,1101,85.15 %
EMSWORTH DIST 1,807,451,209,19,679,84.14 %
EMSWORTH DIST 2,1009,455,331,25,811,80.38 %
ETNA WARD 1,840,378,255,14,647,77.02 %
ETNA WARD 2,714,297,212,18,527,73.81 %
ETNA WARD 3,729,396,192,12,600,82.30 %
FAWN DIST 1,574,365,114,13,492,85.71 %
FAWN DIST 2,936,555,225,12,792,84.62 %
FINDLAY DIST 1,1566,850,432,22,1304,83.27 %
FINDLAY DIST 2,1830,892,563,43,1498,81.86 %
FINDLAY DIST 3,1207,652,353,18,1023,84.76 %
FOREST HILLS DIST 1,621,210,340,1,551,88.73 %
FOREST HILLS DIST 2,649,241,323,4,568,87.52 %
FOREST HILLS DIST 3,647,246,297,9,552,85.32 %
FOREST HILLS DIST 4,708,273,268,13,554,78.25 %
FOREST HILLS DIST 5,730,292,307,12,611,83.70 %
FOREST HILLS DIST 6,607,202,305,9,516,85.01 %
FOREST HILLS DIST 7,800,309,262,22,593,74.13 %
FOREST HILLS DIST 8,743,278,327,15,620,83.45 %
FORWARD DIST 1,367,238,67,4,309,84.20 %
FORWARD DIST 2,834,430,216,8,654,78.42 %
FORWARD DIST 3,401,234,104,5,343,85.54 %
FORWARD DIST 4,479,288,109,4,401,83.72 %
FOX CHAPEL DIST 1,861,394,328,12,734,85.25 %
FOX CHAPEL DIST 2,1035,428,424,11,863,83.38 %
FOX CHAPEL DIST 3,737,310,296,10,616,83.58 %
FOX CHAPEL DIST 4,1224,442,579,1,1022,83.50 %
FOX CHAPEL DIST 5,949,382,388,13,783,82.51 %
FRANKLIN PK WARD 1 DIST 1,1209,551,461,12,1024,84.70 %
FRANKLIN PK WARD 1 DIST 2,1456,574,675,8,1257,86.33 %
FRANKLIN PK WARD 1 DIST 3,1338,526,625,2,1153,86.17 %
FRANKLIN PK WARD 2 DIST 1,1236,491,579,20,1090,88.19 %
FRANKLIN PK WARD 2 DIST 2,1274,472,589,26,1087,85.32 %
FRANKLIN PK WARD 2 DIST 3,1417,594,654,12,1260,88.92 %
FRANKLIN PK WARD 3 DIST 1,1307,485,628,19,1132,86.61 %
FRANKLIN PK WARD 3 DIST 2,806,352,340,2,694,86.10 %
FRANKLIN PK WARD 3 DIST 3,1276,506,595,11,1112,87.15 %
FRAZER,804,496,175,0,671,83.46 %
GLASSPORT DIST 1,576,274,151,12,437,75.87 %
GLASSPORT DIST 2,397,150,84,6,240,60.45 %
GLASSPORT DIST 3,539,200,149,16,365,67.72 %
GLASSPORT DIST 4,244,100,40,6,146,59.84 %
GLASSPORT DIST 5,485,239,134,1,374,77.11 %
GLASSPORT DIST 6,446,198,106,14,318,71.30 %
GLENFIELD,157,76,38,8,122,77.71 %
GREEN TREE DIST 1,811,407,292,14,713,87.92 %
GREEN TREE DIST 2,1084,506,409,16,931,85.89 %
GREEN TREE DIST 3,1031,483,362,11,856,83.03 %
GREEN TREE DIST 4,882,392,326,11,729,82.65 %
HAMPTON DIST 1,1206,569,477,15,1061,87.98 %
HAMPTON DIST 2,1258,615,456,23,1094,86.96 %
HAMPTON DIST 3,1365,573,570,17,1160,84.98 %
HAMPTON DIST 4,656,310,239,21,570,86.89 %
HAMPTON DIST 5,726,328,281,13,622,85.67 %
HAMPTON DIST 6,654,252,267,10,529,80.89 %
HAMPTON DIST 7,1382,625,527,35,1187,85.89 %
HAMPTON DIST 8,975,438,386,23,847,86.87 %
HAMPTON DIST 9,1362,685,481,27,1193,87.59 %
HAMPTON DIST 10,1561,600,695,18,1313,84.11 %
HAMPTON DIST 11,1725,860,654,24,1538,89.16 %
HAMPTON DIST 12,905,421,350,16,787,86.96 %
HAMPTON DIST 13,780,338,316,19,673,86.28 %
HARMAR DIST 1,1313,514,530,23,1067,81.26 %
HARMAR DIST 2,724,339,192,16,547,75.55 %
HARMAR DIST 3,365,178,105,10,293,80.27 %
HARRISON WARD 1 DIST 1,287,164,90,2,256,89.20 %
HARRISON WARD 1 DIST 2,606,291,215,10,516,85.15 %
HARRISON WARD 1 DIST 3,684,374,176,9,559,81.73 %
HARRISON WARD 2 DIST 1,325,163,98,3,264,81.23 %
HARRISON WARD 2 DIST 2,571,253,100,28,381,66.73 %
HARRISON WARD 3 DIST 1,1070,536,368,14,918,85.79 %
HARRISON WARD 3 DIST 2,633,358,168,2,528,83.41 %
HARRISON WARD 4 DIST 1,709,393,183,12,588,82.93 %
HARRISON WARD 4 DIST 2,595,300,168,0,468,78.66 %
HARRISON WARD 5 DIST 1,503,197,141,1,339,67.40 %
HARRISON WARD 5 DIST 2,796,439,205,13,657,82.54 %
HAYSVILLE,67,40,15,1,56,83.58 %
HEIDELBERG,937,546,202,13,761,81.22 %
HOMESTEAD WARD 1 DIST 1,560,172,192,2,366,65.36 %
HOMESTEAD WARD 1 DIST 2,344,128,89,10,227,65.99 %
HOMESTEAD WARD 2 DIST 1,402,151,104,11,266,66.17 %
HOMESTEAD WARD 2 DIST 2,310,134,68,3,205,66.13 %
HOMESTEAD WARD 3 DIST 1,475,170,89,15,274,57.68 %
HOMESTEAD WARD 3 DIST 2,281,89,54,19,162,57.65 %
INDIANA DIST 1,1001,470,339,12,821,82.02 %
INDIANA DIST 2,887,438,292,19,749,84.44 %
INDIANA DIST 3,1385,607,475,24,1106,79.86 %
INDIANA DIST 4,1148,525,425,22,972,84.67 %
INDIANA DIST 5,933,427,363,24,814,87.25 %
INGRAM DIST 1,834,389,260,11,660,79.14 %
INGRAM DIST 2,648,298,198,13,509,78.55 %
INGRAM DIST 3,946,472,286,26,784,82.88 %
JEFFERSON HL DIST 1,1763,856,631,45,1532,86.90 %
JEFFERSON HL DIST 2,831,458,210,18,686,82.55 %
JEFFERSON HL DIST 3,698,318,265,15,598,85.67 %
JEFFERSON HL DIST 4,676,282,234,0,516,76.33 %
JEFFERSON HL DIST 5,2082,865,824,23,1712,82.23 %
JEFFERSON HL DIST 6,1012,655,199,17,871,86.07 %
JEFFERSON HL DIST 7,387,220,115,4,339,87.60 %
JEFFERSON HL DIST 8,1328,645,515,17,1177,88.63 %
KENNEDY DIST 1,1546,692,593,3,1288,83.31 %
KENNEDY DIST 2,911,387,319,16,722,79.25 %
KENNEDY DIST 3,991,461,366,14,841,84.86 %
KENNEDY DIST 4,447,207,165,8,380,85.01 %
KENNEDY DIST 5,1390,665,481,34,1180,84.89 %
KENNEDY DIST 6,930,420,337,12,769,82.69 %
KENNEDY DIST 7,569,279,191,1,471,82.78 %
KILBUCK,620,334,204,16,554,89.35 %
LEET DIST 1,417,265,86,5,356,85.37 %
LEET DIST 2,806,378,303,13,694,86.10 %
LEETSDALE,877,426,210,29,665,75.83 %
LIBERTY DIST 1,892,525,200,9,734,82.29 %
LIBERTY DIST 2,804,469,181,14,664,82.59 %
LINCOLN,698,450,139,11,600,85.96 %
MARSHALL DIST 1,954,342,432,15,789,82.70 %
MARSHALL DIST 2,1136,534,412,14,960,84.51 %
MARSHALL DIST 3,831,332,357,15,704,84.72 %
MARSHALL DIST 4,1194,467,553,15,1035,86.68 %
MARSHALL DIST 5,908,313,461,11,785,86.45 %
MARSHALL DIST 6,1021,444,425,7,876,85.80 %
MARSHALL DIST 7,1296,510,532,18,1060,81.79 %
MCCANDLESS WARD 1 DIST 1,1148,438,522,22,982,85.54 %
MCCANDLESS WARD 1 DIST 2,805,243,354,10,607,75.40 %
MCCANDLESS WARD 1 DIST 3,1288,486,510,15,1011,78.49 %
MCCANDLESS WARD 2 DIST 1,1422,474,698,18,1190,83.68 %
MCCANDLESS WARD 2 DIST 2,888,374,395,11,780,87.84 %
MCCANDLESS WARD 2 DIST 3,890,359,394,6,759,85.28 %
MCCANDLESS WARD 3 DIST 1,970,380,418,13,811,83.61 %
MCCANDLESS WARD 3 DIST 2,1098,480,441,15,936,85.25 %
MCCANDLESS WARD 3 DIST 3,1127,502,480,12,994,88.20 %
MCCANDLESS WARD 4 DIST 1,1532,615,704,17,1336,87.21 %
MCCANDLESS WARD 4 DIST 2,958,402,395,14,811,84.66 %
MCCANDLESS WARD 4 DIST 3,746,316,353,6,675,90.48 %
MCCANDLESS WARD 5 DIST 1,858,390,338,4,732,85.31 %
MCCANDLESS WARD 5 DIST 2,1414,534,567,20,1121,79.28 %
MCCANDLESS WARD 5 DIST 3,1007,372,469,12,853,84.71 %
MCCANDLESS WARD 6 DIST 1,488,201,223,1,425,87.09 %
MCCANDLESS WARD 6 DIST 2,1057,404,518,12,934,88.36 %
MCCANDLESS WARD 6 DIST 3,1918,589,986,24,1599,83.37 %
MCCANDLESS WARD 7 DIST 1,1667,587,739,14,1340,80.38 %
MCCANDLESS WARD 7 DIST 2,1018,375,492,8,875,85.95 %
MCCANDLESS WARD 7 DIST 3,529,197,257,8,462,87.33 %
MCDONALD,229,134,45,3,182,79.48 %
MCKEESPORT WARD 1,9,3,1,0,4,44.44 %
MCKEESPORT WARD 2,245,46,30,3,79,32.24 %
MCKEESPORT WARD 3 DIST 1,299,80,60,1,141,47.16 %
MCKEESPORT WARD 3 DIST 2,118,29,40,2,71,60.17 %
MCKEESPORT WARD 4,309,77,56,9,142,45.95 %
MCKEESPORT WARD 5,472,105,115,4,224,47.46 %
MCKEESPORT WARD 6 DIST 1,349,82,75,2,159,45.56 %
MCKEESPORT WARD 6 DIST 2,291,77,51,7,135,46.39 %
MCKEESPORT WARD 7 DIST 1,469,156,140,5,301,64.18 %
MCKEESPORT WARD 7 DIST 2,275,77,86,3,166,60.36 %
MCKEESPORT WARD 7 DIST 3,338,116,78,7,201,59.47 %
MCKEESPORT WARD 7 DIST 4,425,154,86,3,243,57.18 %
MCKEESPORT WARD 7 DIST 5,536,209,126,2,337,62.87 %
MCKEESPORT WARD 7 DIST 6,479,173,104,5,282,58.87 %
MCKEESPORT WARD 7 DIST 7,357,94,85,13,192,53.78 %
MCKEESPORT WARD 8 DIST 1,280,110,75,4,189,67.50 %
MCKEESPORT WARD 8 DIST 2,511,187,153,6,346,67.71 %
MCKEESPORT WARD 8 DIST 3,561,165,149,16,330,58.82 %
MCKEESPORT WARD 8 DIST 4,464,202,114,9,325,70.04 %
MCKEESPORT WARD 8 DIST 5,544,162,84,10,256,47.06 %
MCKEESPORT WARD 8 DIST 6,218,97,55,11,163,74.77 %
MCKEESPORT WARD 9 DIST 1,448,183,122,2,307,68.53 %
MCKEESPORT WARD 9 DIST 2,579,255,123,9,387,66.84 %
MCKEESPORT WARD 9 DIST 3,418,175,99,11,285,68.18 %
MCKEESPORT WARD 10 DIST 1,322,109,65,5,179,55.59 %
MCKEESPORT WARD 10 DIST 2,329,123,102,10,235,71.43 %
MCKEESPORT WARD 11 DIST 1,423,189,109,6,304,71.87 %
MCKEESPORT WARD 11 DIST 2,388,169,110,2,281,72.42 %
MCKEESPORT WARD 11 DIST 3,270,103,105,0,208,77.04 %
MCKEESPORT WARD 12 DIST 1,317,163,72,0,235,74.13 %
MCKEESPORT WARD 12 DIST 2,375,191,101,11,303,80.80 %
MCKEESPORT WARD 12 DIST 3,559,279,196,9,484,86.58 %
MCKEES ROCKS WARD 1 DIST 1,240,54,11,4,69,28.75 %
MCKEES ROCKS WARD 1 DIST 2,555,186,131,16,333,60.00 %
MCKEES ROCKS WARD 2 DIST 1,664,240,120,18,378,56.93 %
MCKEES ROCKS WARD 2 DIST 2,566,194,99,17,310,54.77 %
MCKEES ROCKS WARD 3 DIST 1,720,248,227,14,489,67.92 %
MCKEES ROCKS WARD 3 DIST 2,556,195,117,5,317,57.01 %
MCKEES ROCKS WARD 3 DIST 3,528,181,141,14,336,63.64 %
MILLVALE DIST 1,510,228,126,7,361,70.78 %
MILLVALE DIST 2,470,212,106,5,323,68.72 %
MILLVALE DIST 3,453,174,143,3,320,70.64 %
MILLVALE DIST 4,453,211,113,7,331,73.07 %
MILLVALE DIST 5,517,230,165,6,401,77.56 %
MONROEVILLE WARD 1 DIST 1,692,287,242,4,533,77.02 %
MONROEVILLE WARD 1 DIST 2,656,259,286,2,547,83.38 %
MONROEVILLE WARD 1 DIST 3,830,284,430,11,725,87.35 %
MONROEVILLE WARD 1 DIST 4,931,281,340,12,633,67.99 %
MONROEVILLE WARD 2 DIST 1,937,378,408,16,802,85.59 %
MONROEVILLE WARD 2 DIST 2,1016,371,487,9,867,85.33 %
MONROEVILLE WARD 2 DIST 3,1082,394,493,12,899,83.09 %
MONROEVILLE WARD 3 DIST 1,1241,437,556,15,1008,81.22 %
MONROEVILLE WARD 3 DIST 2,632,285,239,8,532,84.18 %
MONROEVILLE WARD 3 DIST 3,1002,368,490,13,871,86.93 %
MONROEVILLE WARD 3 DIST 4,443,168,206,3,377,85.10 %
MONROEVILLE WARD 4 DIST 1,661,271,278,12,561,84.87 %
MONROEVILLE WARD 4 DIST 2,1036,450,364,16,830,80.12 %
MONROEVILLE WARD 4 DIST 3,974,417,380,23,820,84.19 %
MONROEVILLE WARD 5 DIST 1,586,280,191,11,482,82.25 %
MONROEVILLE WARD 5 DIST 2,904,248,361,18,627,69.36 %
MONROEVILLE WARD 5 DIST 3,947,315,370,28,713,75.29 %
MONROEVILLE WARD 5 DIST 4,695,210,244,12,466,67.05 %
MONROEVILLE WARD 6 DIST 1,837,367,309,4,680,81.24 %
MONROEVILLE WARD 6 DIST 2,895,323,346,17,686,76.65 %
MONROEVILLE WARD 6 DIST 3,1122,370,349,12,731,65.15 %
MONROEVILLE WARD 6 DIST 4,377,79,173,10,262,69.50 %
MONROEVILLE WARD 7 DIST 1,1384,491,633,18,1142,82.51 %
MONROEVILLE WARD 7 DIST 2,853,340,323,14,677,79.37 %
MONROEVILLE WARD 7 DIST 3,610,246,240,32,518,84.92 %
MOON DIST 1,1248,437,340,10,787,63.06 %
MOON DIST 2,1851,759,759,16,1534,82.87 %
MOON DIST 3,1447,564,496,20,1080,74.64 %
MOON DIST 4,782,374,271,12,657,84.02 %
MOON DIST 5,2535,1058,1023,21,2102,82.92 %
MOON DIST 6,2408,1105,869,23,1997,82.93 %
MOON DIST 7,1604,595,553,32,1180,73.57 %
MOON DIST 8,1054,457,393,20,870,82.54 %
MOON DIST 9,2026,799,727,21,1547,76.36 %
MOON DIST 10,786,381,256,12,649,82.57 %
MOON DIST 11,1373,615,514,20,1149,83.69 %
MOON DIST 12,1035,509,371,10,890,85.99 %
MOON DIST 13,718,347,233,5,585,81.48 %
MT LEBANON WARD 1 DIST 1,835,300,387,13,700,83.83 %
MT LEBANON WARD 1 DIST 2,682,260,286,11,557,81.67 %
MT LEBANON WARD 1 DIST 3,656,235,329,6,570,86.89 %
MT LEBANON WARD 1 DIST 4,782,287,387,4,678,86.70 %
MT LEBANON WARD 1 DIST 5,631,248,283,3,534,84.63 %
MT LEBANON WARD 1 DIST 6,1084,344,518,10,872,80.44 %
MT LEBANON WARD 1 DIST 7,767,252,364,16,632,82.40 %
MT LEBANON WARD 2 DIST 1,995,326,507,18,851,85.53 %
MT LEBANON WARD 2 DIST 2,600,215,267,8,490,81.67 %
MT LEBANON WARD 2 DIST 3,718,234,360,10,604,84.12 %
MT LEBANON WARD 2 DIST 4,580,194,292,9,495,85.34 %
MT LEBANON WARD 2 DIST 5,576,199,285,5,489,84.90 %
MT LEBANON WARD 2 DIST 6,586,216,291,13,520,88.74 %
MT LEBANON WARD 2 DIST 7,656,255,316,9,580,88.41 %
MT LEBANON WARD 2 DIST 8,1021,265,546,9,820,80.31 %
MT LEBANON WARD 3 DIST 1,656,243,315,11,569,86.74 %
MT LEBANON WARD 3 DIST 2,895,351,419,9,779,87.04 %
MT LEBANON WARD 3 DIST 3,715,245,355,6,606,84.76 %
MT LEBANON WARD 3 DIST 4,761,261,316,8,585,76.87 %
MT LEBANON WARD 3 DIST 5,705,285,315,8,608,86.24 %
MT LEBANON WARD 3 DIST 6,466,201,207,5,413,88.63 %
MT LEBANON WARD 3 DIST 7,878,276,441,5,722,82.23 %
MT LEBANON WARD 3 DIST 8,322,131,134,1,266,82.61 %
MT LEBANON WARD 4 DIST 1,802,263,340,12,615,76.68 %
MT LEBANON WARD 4 DIST 2,904,344,393,13,750,82.96 %
MT LEBANON WARD 4 DIST 3,757,258,337,9,604,79.79 %
MT LEBANON WARD 4 DIST 4,665,275,305,9,589,88.57 %
MT LEBANON WARD 4 DIST 5,657,280,293,7,580,88.28 %
MT LEBANON WARD 4 DIST 6,690,272,309,14,595,86.23 %
MT LEBANON WARD 4 DIST 7,868,264,422,13,699,80.53 %
MT LEBANON WARD 5 DIST 1,608,224,283,9,516,84.87 %
MT LEBANON WARD 5 DIST 2,467,139,181,9,329,70.45 %
MT LEBANON WARD 5 DIST 3,617,214,282,11,507,82.17 %
MT LEBANON WARD 5 DIST 4,612,239,279,5,523,85.46 %
MT LEBANON WARD 5 DIST 5,644,218,340,8,566,87.89 %
MT LEBANON WARD 5 DIST 6,487,176,235,5,416,85.42 %
MT LEBANON WARD 5 DIST 7,795,290,385,8,683,85.91 %
MT LEBANON WARD 5 DIST 8,985,318,453,15,786,79.80 %
MT OLIVER DIST 1,722,230,150,4,384,53.19 %
MT OLIVER DIST 2,746,271,155,11,437,58.58 %
MT OLIVER DIST 3,493,179,128,2,309,62.68 %
MT OLIVER DIST 4,318,115,89,10,214,67.30 %
MUNHALL DIST 1,476,161,138,7,306,64.29 %
MUNHALL DIST 2,508,158,156,6,320,62.99 %
MUNHALL DIST 3,500,196,115,20,331,66.20 %
MUNHALL DIST 4,439,177,148,17,342,77.90 %
MUNHALL DIST 5,739,333,266,2,601,81.33 %
MUNHALL DIST 6,729,341,227,14,582,79.84 %
MUNHALL DIST 7,1186,466,452,18,936,78.92 %
MUNHALL DIST 8,660,311,253,11,575,87.12 %
MUNHALL DIST 9,734,344,208,13,565,76.98 %
MUNHALL DIST 10,536,256,151,11,418,77.99 %
MUNHALL DIST 11,950,407,392,13,812,85.47 %
MUNHALL DIST 12,549,288,181,3,472,85.97 %
NEVILLE WARD 1,268,143,53,4,200,74.63 %
NEVILLE WARD 2,231,92,51,2,145,62.77 %
NEVILLE WARD 3,265,149,71,9,229,86.42 %
N BRADDOCK WARD 1 DIST 1,219,79,96,6,181,82.65 %
N BRADDOCK WARD 1 DIST 2,509,190,155,6,351,68.96 %
N BRADDOCK WARD 1 DIST 3,531,186,135,18,339,63.84 %
N BRADDOCK WARD 2 DIST 1,437,142,97,5,244,55.84 %
N BRADDOCK WARD 2 DIST 2,591,211,163,14,388,65.65 %
N BRADDOCK WARD 3 DIST 1,413,134,121,6,261,63.20 %
N BRADDOCK WARD 3 DIST 2,496,159,118,10,287,57.86 %
N FAYETTE DIST 1,2176,1046,730,15,1791,82.31 %
N FAYETTE DIST 2,2543,1024,845,54,1923,75.62 %
N FAYETTE DIST 3,2436,964,921,32,1917,78.69 %
N FAYETTE DIST 4,1128,481,302,10,793,70.30 %
N FAYETTE DIST 5,2829,1265,980,31,2276,80.45 %
N VERSAILLES WARD 1 DIST 1,671,319,203,5,527,78.54 %
N VERSAILLES WARD 1 DIST 2,650,317,202,25,544,83.69 %
N VERSAILLES WARD 2 DIST 1,669,313,195,11,519,77.58 %
N VERSAILLES WARD 2 DIST 2,197,89,62,5,156,79.19 %
N VERSAILLES WARD 3 DIST 1,506,235,172,22,429,84.78 %
N VERSAILLES WARD 3 DIST 2,624,213,240,20,473,75.80 %
N VERSAILLES WARD 4 DIST 1,507,248,117,7,372,73.37 %
N VERSAILLES WARD 4 DIST 2,402,204,105,10,319,79.35 %
N VERSAILLES WARD 5 DIST 1,571,199,137,10,346,60.60 %
N VERSAILLES WARD 5 DIST 2,400,139,121,9,269,67.25 %
N VERSAILLES WARD 6 DIST 1,648,319,200,7,526,81.17 %
N VERSAILLES WARD 6 DIST 2,562,278,179,13,470,83.63 %
N VERSAILLES WARD 7,676,228,199,26,453,67.01 %
OAKDALE DIST 1,612,371,129,9,509,83.17 %
OAKDALE DIST 2,451,244,137,7,388,86.03 %
OAKMONT DIST 1,858,403,330,8,741,86.36 %
OAKMONT DIST 2,1094,425,462,16,903,82.54 %
OAKMONT DIST 3,770,397,237,13,647,84.03 %
OAKMONT DIST 4,898,413,316,9,738,82.18 %
OAKMONT DIST 5,712,301,259,10,570,80.06 %
OAKMONT DIST 6,1266,501,537,21,1059,83.65 %
OHARA WARD 1 DIST 1,1075,307,503,13,823,76.56 %
OHARA WARD 1 DIST 2,652,243,291,5,539,82.67 %
OHARA WARD 2 DIST 1,626,264,263,7,534,85.30 %
OHARA WARD 2 DIST 2,937,361,402,18,781,83.35 %
OHARA WARD 3 DIST 1,669,318,255,7,580,86.70 %
OHARA WARD 3 DIST 2,597,279,206,7,492,82.41 %
OHARA WARD 4 DIST 1,582,148,308,7,463,79.55 %
OHARA WARD 4 DIST 2,789,292,393,16,701,88.85 %
OHARA WARD 5 DIST 1,755,292,329,10,631,83.58 %
OHARA WARD 5 DIST 2,893,300,448,13,761,85.22 %
OHIO DIST 1,1446,647,568,14,1229,84.99 %
OHIO DIST 2,1815,700,898,30,1628,89.70 %
OHIO DIST 3,2130,860,862,7,1729,81.17 %
GLEN OSBORNE,462,229,161,10,400,86.58 %
PENN HILLS WARD 1 DIST 1,745,134,332,7,473,63.49 %
PENN HILLS WARD 1 DIST 2,737,199,343,13,555,75.31 %
PENN HILLS WARD 1 DIST 3,498,123,169,11,303,60.84 %
PENN HILLS WARD 1 DIST 4,328,69,135,13,217,66.16 %
PENN HILLS WARD 1 DIST 5,207,56,71,2,129,62.32 %
PENN HILLS WARD 2 DIST 1,718,176,308,13,497,69.22 %
PENN HILLS WARD 2 DIST 2,743,212,280,7,499,67.16 %
PENN HILLS WARD 2 DIST 3,856,275,354,2,631,73.71 %
PENN HILLS WARD 2 DIST 4,594,158,333,3,494,83.16 %
PENN HILLS WARD 3 DIST 1,758,245,338,11,594,78.36 %
PENN HILLS WARD 3 DIST 2,518,160,223,8,391,75.48 %
PENN HILLS WARD 3 DIST 3,656,163,331,7,501,76.37 %
PENN HILLS WARD 3 DIST 4,835,249,349,14,612,73.29 %
PENN HILLS WARD 3 DIST 5,453,126,164,9,299,66.00 %
PENN HILLS WARD 3 DIST 6,492,169,189,7,365,74.19 %
PENN HILLS WARD 4 DIST 1,557,147,269,12,428,76.84 %
PENN HILLS WARD 4 DIST 2,737,233,277,3,513,69.61 %
PENN HILLS WARD 4 DIST 3,774,239,331,14,584,75.45 %
PENN HILLS WARD 4 DIST 4,598,179,272,15,466,77.93 %
PENN HILLS WARD 4 DIST 5,592,183,271,10,464,78.38 %
PENN HILLS WARD 5 DIST 1,753,256,291,8,555,73.71 %
PENN HILLS WARD 5 DIST 2,609,204,210,21,435,71.43 %
PENN HILLS WARD 5 DIST 3,696,235,324,20,579,83.19 %
PENN HILLS WARD 5 DIST 4,624,242,286,1,529,84.78 %
PENN HILLS WARD 5 DIST 5,524,177,245,5,427,81.49 %
PENN HILLS WARD 5 DIST 6,713,223,311,10,544,76.30 %
PENN HILLS WARD 6 DIST 1,590,222,198,6,426,72.20 %
PENN HILLS WARD 6 DIST 2,662,229,248,10,487,73.56 %
PENN HILLS WARD 6 DIST 3,547,174,250,16,440,80.44 %
PENN HILLS WARD 6 DIST 4,591,185,217,4,406,68.70 %
PENN HILLS WARD 6 DIST 5,624,199,261,16,476,76.28 %
PENN HILLS WARD 6 DIST 6,579,190,255,11,456,78.76 %
PENN HILLS WARD 7 DIST 1,655,205,294,17,516,78.78 %
PENN HILLS WARD 7 DIST 2,668,211,251,21,483,72.31 %
PENN HILLS WARD 7 DIST 3,917,279,407,22,708,77.21 %
PENN HILLS WARD 7 DIST 4,628,242,249,11,502,79.94 %
PENN HILLS WARD 7 DIST 5,725,248,323,14,585,80.69 %
PENN HILLS WARD 7 DIST 6,742,270,272,8,550,74.12 %
PENN HILLS WARD 7 DIST 7,709,276,219,11,506,71.37 %
PENN HILLS WARD 8 DIST 1,659,242,292,15,549,83.31 %
PENN HILLS WARD 8 DIST 2,560,258,185,19,462,82.50 %
PENN HILLS WARD 8 DIST 3,536,220,222,8,450,83.96 %
PENN HILLS WARD 8 DIST 4,652,245,298,8,551,84.51 %
PENN HILLS WARD 8 DIST 5,922,299,407,12,718,77.87 %
PENN HILLS WARD 8 DIST 6,478,177,221,6,404,84.52 %
PENN HILLS WARD 9 DIST 1,513,210,229,7,446,86.94 %
PENN HILLS WARD 9 DIST 2,585,215,242,10,467,79.83 %
PENN HILLS WARD 9 DIST 3,854,319,350,19,688,80.56 %
PENN HILLS WARD 9 DIST 4,606,265,236,9,510,84.16 %
PENN HILLS WARD 9 DIST 5,296,71,134,5,210,70.95 %
PINE DIST 1,1446,564,603,24,1191,82.37 %
PINE DIST 2,2044,812,878,26,1716,83.95 %
PINE DIST 3,464,202,179,8,389,83.84 %
PINE DIST 4,1407,587,590,16,1193,84.79 %
PINE DIST 5,1971,765,803,30,1598,81.08 %
PINE DIST 6,831,367,340,5,712,85.68 %
PINE DIST 7,1478,639,560,21,1220,82.54 %
PINE DIST 8,1138,500,422,17,939,82.51 %
PITCAIRN DIST 1,894,359,185,17,561,62.75 %
PITCAIRN DIST 2,466,186,64,6,256,54.94 %
PITCAIRN DIST 3,645,357,137,21,515,79.84 %
PITTSBURGH WARD 1 DIST 1,2993,355,602,23,980,32.74 %
PITTSBURGH WARD 1 DIST 2,658,110,207,12,329,50.00 %
PITTSBURGH WARD 2 DIST 1,2162,587,956,12,1555,71.92 %
PITTSBURGH WARD 2 DIST 2,1591,420,726,11,1157,72.72 %
PITTSBURGH WARD 3 DIST 1,259,57,101,6,164,63.32 %
PITTSBURGH WARD 3 DIST 2,665,201,277,9,487,73.23 %
PITTSBURGH WARD 3 DIST 3,355,112,122,7,241,67.89 %
PITTSBURGH WARD 3 DIST 4,493,102,168,3,273,55.38 %
PITTSBURGH WARD 3 DIST 5,490,113,165,14,292,59.59 %
PITTSBURGH WARD 4 DIST 1,261,39,47,2,88,33.72 %
PITTSBURGH WARD 4 DIST 2,748,173,212,4,389,52.01 %
PITTSBURGH WARD 4 DIST 3,354,102,97,3,202,57.06 %
PITTSBURGH WARD 4 DIST 4,229,68,69,8,145,63.32 %
PITTSBURGH WARD 4 DIST 5,916,254,182,10,446,48.69 %
PITTSBURGH WARD 4 DIST 6,759,174,158,5,337,44.40 %
PITTSBURGH WARD 4 DIST 7,2217,547,429,21,997,44.97 %
PITTSBURGH WARD 4 DIST 8,2409,468,318,28,814,33.79 %
PITTSBURGH WARD 4 DIST 9,884,216,359,2,577,65.27 %
PITTSBURGH WARD 4 DIST 10,609,116,208,2,326,53.53 %
PITTSBURGH WARD 4 DIST 11,567,100,326,2,428,75.49 %
PITTSBURGH WARD 4 DIST 12,663,92,259,4,355,53.54 %
PITTSBURGH WARD 4 DIST 13,646,125,165,0,290,44.89 %
PITTSBURGH WARD 4 DIST 14,1403,345,269,6,620,44.19 %
PITTSBURGH WARD 4 DIST 15,1023,244,264,8,516,50.44 %
PITTSBURGH WARD 4 DIST 16,1479,407,359,2,768,51.93 %
PITTSBURGH WARD 4 DIST 17,630,216,203,5,424,67.30 %
PITTSBURGH WARD 4 DIST 18,703,207,202,7,416,59.17 %
PITTSBURGH WARD 4 DIST 19,295,64,69,3,136,46.10 %
PITTSBURGH WARD 5 DIST 1,268,84,82,10,176,65.67 %
PITTSBURGH WARD 5 DIST 2,374,99,140,6,245,65.51 %
PITTSBURGH WARD 5 DIST 3,149,43,51,5,99,66.44 %
PITTSBURGH WARD 5 DIST 4,283,69,72,12,153,54.06 %
PITTSBURGH WARD 5 DIST 5,214,43,83,11,137,64.02 %
PITTSBURGH WARD 5 DIST 6,548,113,101,17,231,42.15 %
PITTSBURGH WARD 5 DIST 7,409,96,145,15,256,62.59 %
PITTSBURGH WARD 5 DIST 8,441,110,156,14,280,63.49 %
PITTSBURGH WARD 5 DIST 9,1124,229,411,10,650,57.83 %
PITTSBURGH WARD 5 DIST 10,464,144,151,8,303,65.30 %
PITTSBURGH WARD 5 DIST 11,361,91,118,9,218,60.39 %
PITTSBURGH WARD 5 DIST 12,367,124,118,2,244,66.49 %
PITTSBURGH WARD 5 DIST 13,259,74,79,3,156,60.23 %
PITTSBURGH WARD 5 DIST 14,265,49,109,13,171,64.53 %
PITTSBURGH WARD 5 DIST 15,250,65,69,12,146,58.40 %
PITTSBURGH WARD 5 DIST 16,186,45,47,4,96,51.61 %
PITTSBURGH WARD 5 DIST 17,249,63,91,4,158,63.45 %
PITTSBURGH WARD 5 DIST 18,65,18,26,0,44,67.69 %
PITTSBURGH WARD 6 DIST 1,1127,296,530,11,837,74.27 %
PITTSBURGH WARD 6 DIST 2,621,175,273,4,452,72.79 %
PITTSBURGH WARD 6 DIST 3,782,195,345,9,549,70.20 %
PITTSBURGH WARD 6 DIST 4,563,184,235,18,437,77.62 %
PITTSBURGH WARD 6 DIST 5,501,151,215,9,375,74.85 %
PITTSBURGH WARD 7 DIST 1,655,152,248,5,405,61.83 %
PITTSBURGH WARD 7 DIST 2,1073,269,496,9,774,72.13 %
PITTSBURGH WARD 7 DIST 3,771,146,334,2,482,62.52 %
PITTSBURGH WARD 7 DIST 4,1201,270,459,11,740,61.62 %
PITTSBURGH WARD 7 DIST 5,823,195,313,5,513,62.33 %
PITTSBURGH WARD 7 DIST 6,741,179,315,7,501,67.61 %
PITTSBURGH WARD 7 DIST 7,787,174,306,15,495,62.90 %
PITTSBURGH WARD 7 DIST 8,773,181,295,7,483,62.48 %
PITTSBURGH WARD 7 DIST 9,853,196,380,0,576,67.53 %
PITTSBURGH WARD 7 DIST 10,1120,256,507,8,771,68.84 %
PITTSBURGH WARD 7 DIST 11,1246,250,561,11,822,65.97 %
PITTSBURGH WARD 7 DIST 12,1179,237,571,6,814,69.04 %
PITTSBURGH WARD 7 DIST 13,558,108,190,7,305,54.66 %
PITTSBURGH WARD 7 DIST 14,465,103,204,2,309,66.45 %
PITTSBURGH WARD 8 DIST 1,376,113,182,5,300,79.79 %
PITTSBURGH WARD 8 DIST 2,637,211,280,8,499,78.34 %
PITTSBURGH WARD 8 DIST 3,880,269,318,3,590,67.05 %
PITTSBURGH WARD 8 DIST 4,870,230,358,3,591,67.93 %
PITTSBURGH WARD 8 DIST 5,642,203,279,7,489,76.17 %
PITTSBURGH WARD 8 DIST 6,445,137,173,7,317,71.24 %
PITTSBURGH WARD 8 DIST 7,868,205,389,13,607,69.93 %
PITTSBURGH WARD 8 DIST 8,685,185,303,3,491,71.68 %
PITTSBURGH WARD 8 DIST 9,877,192,363,10,565,64.42 %
PITTSBURGH WARD 8 DIST 10,678,165,308,4,477,70.35 %
PITTSBURGH WARD 8 DIST 11,723,166,299,6,471,65.15 %
PITTSBURGH WARD 8 DIST 12,626,173,256,8,437,69.81 %
PITTSBURGH WARD 8 DIST 13,556,115,218,6,339,60.97 %
PITTSBURGH WARD 9 DIST 1,615,171,261,9,441,71.71 %
PITTSBURGH WARD 9 DIST 2,594,164,268,10,442,74.41 %
PITTSBURGH WARD 9 DIST 3,655,194,291,7,492,75.11 %
PITTSBURGH WARD 9 DIST 4,652,194,277,10,481,73.77 %
PITTSBURGH WARD 9 DIST 5,668,185,300,14,499,74.70 %
PITTSBURGH WARD 9 DIST 6,585,183,264,10,457,78.12 %
PITTSBURGH WARD 9 DIST 7,441,105,223,4,332,75.28 %
PITTSBURGH WARD 9 DIST 8,737,235,325,7,567,76.93 %
PITTSBURGH WARD 9 DIST 9,651,160,278,13,451,69.28 %
PITTSBURGH WARD 10 DIST 1,640,165,299,4,468,73.13 %
PITTSBURGH WARD 10 DIST 2,637,208,261,6,475,74.57 %
PITTSBURGH WARD 10 DIST 3,722,230,286,13,529,73.27 %
PITTSBURGH WARD 10 DIST 4,543,202,249,4,455,83.79 %
PITTSBURGH WARD 10 DIST 5,511,182,221,8,411,80.43 %
PITTSBURGH WARD 10 DIST 6,506,197,179,20,396,78.26 %
PITTSBURGH WARD 10 DIST 7,632,218,293,3,514,81.33 %
PITTSBURGH WARD 10 DIST 8,611,221,282,7,510,83.47 %
PITTSBURGH WARD 10 DIST 9,548,228,228,5,461,84.12 %
PITTSBURGH WARD 10 DIST 10,600,207,308,7,522,87.00 %
PITTSBURGH WARD 10 DIST 11,645,215,298,1,514,79.69 %
PITTSBURGH WARD 10 DIST 12,565,152,260,19,431,76.28 %
PITTSBURGH WARD 10 DIST 13,567,202,247,13,462,81.48 %
PITTSBURGH WARD 10 DIST 14,570,195,250,10,455,79.82 %
PITTSBURGH WARD 10 DIST 15,381,104,142,2,248,65.09 %
PITTSBURGH WARD 10 DIST 16,328,89,92,15,196,59.76 %
PITTSBURGH WARD 10 DIST 17,469,135,182,0,317,67.59 %
PITTSBURGH WARD 10 DIST 18,536,164,207,9,380,70.90 %
PITTSBURGH WARD 10 DIST 19,463,155,168,9,332,71.71 %
PITTSBURGH WARD 11 DIST 1,637,160,309,10,479,75.20 %
PITTSBURGH WARD 11 DIST 2,577,127,243,9,379,65.68 %
PITTSBURGH WARD 11 DIST 3,439,97,182,4,283,64.46 %
PITTSBURGH WARD 11 DIST 4,512,108,203,8,319,62.30 %
PITTSBURGH WARD 11 DIST 5,577,161,221,3,385,66.72 %
PITTSBURGH WARD 11 DIST 6,873,215,400,6,621,71.13 %
PITTSBURGH WARD 11 DIST 7,675,145,387,0,532,78.81 %
PITTSBURGH WARD 11 DIST 8,544,129,247,4,380,69.85 %
PITTSBURGH WARD 11 DIST 9,670,174,348,11,533,79.55 %
PITTSBURGH WARD 11 DIST 10,561,148,323,4,475,84.67 %
PITTSBURGH WARD 11 DIST 11,668,143,340,13,496,74.25 %
PITTSBURGH WARD 11 DIST 12,712,173,375,6,554,77.81 %
PITTSBURGH WARD 11 DIST 13,715,179,376,14,569,79.58 %
PITTSBURGH WARD 11 DIST 14,627,165,217,9,391,62.36 %
PITTSBURGH WARD 11 DIST 15,370,81,85,14,180,48.65 %
PITTSBURGH WARD 11 DIST 16,602,142,262,14,418,69.44 %
PITTSBURGH WARD 11 DIST 17,707,194,283,9,486,68.74 %
PITTSBURGH WARD 11 DIST 18,522,126,193,16,335,64.18 %
PITTSBURGH WARD 12 DIST 1,226,57,55,5,117,51.77 %
PITTSBURGH WARD 12 DIST 2,299,108,58,4,170,56.86 %
PITTSBURGH WARD 12 DIST 3,159,57,35,0,92,57.86 %
PITTSBURGH WARD 12 DIST 4,324,105,88,9,202,62.35 %
PITTSBURGH WARD 12 DIST 5,143,51,31,0,82,57.34 %
PITTSBURGH WARD 12 DIST 6,215,67,49,6,122,56.74 %
PITTSBURGH WARD 12 DIST 7,319,91,89,1,181,56.74 %
PITTSBURGH WARD 12 DIST 8,200,73,35,3,111,55.50 %
PITTSBURGH WARD 12 DIST 9,303,62,87,5,154,50.83 %
PITTSBURGH WARD 12 DIST 10,423,129,149,0,278,65.72 %
PITTSBURGH WARD 12 DIST 11,456,121,148,16,285,62.50 %
PITTSBURGH WARD 12 DIST 12,627,112,193,9,314,50.08 %
PITTSBURGH WARD 12 DIST 13,399,113,131,18,262,65.66 %
PITTSBURGH WARD 12 DIST 14,319,99,92,2,193,60.50 %
PITTSBURGH WARD 12 DIST 15,560,171,202,4,377,67.32 %
PITTSBURGH WARD 12 DIST 16,382,83,152,3,238,62.30 %
PITTSBURGH WARD 13 DIST 1,321,98,96,13,207,64.49 %
PITTSBURGH WARD 13 DIST 2,364,114,77,16,207,56.87 %
PITTSBURGH WARD 13 DIST 3,309,101,77,14,192,62.14 %
PITTSBURGH WARD 13 DIST 4,303,78,83,11,172,56.77 %
PITTSBURGH WARD 13 DIST 5,316,86,94,3,183,57.91 %
PITTSBURGH WARD 13 DIST 6,365,115,74,18,207,56.71 %
PITTSBURGH WARD 13 DIST 7,372,106,72,10,188,50.54 %
PITTSBURGH WARD 13 DIST 8,298,84,78,14,176,59.06 %
PITTSBURGH WARD 13 DIST 9,284,73,73,2,148,52.11 %
PITTSBURGH WARD 13 DIST 10,179,58,38,3,99,55.31 %
PITTSBURGH WARD 13 DIST 11,395,119,60,1,180,45.57 %
PITTSBURGH WARD 13 DIST 12,386,115,123,1,239,61.92 %
PITTSBURGH WARD 13 DIST 13,264,73,47,9,129,48.86 %
PITTSBURGH WARD 13 DIST 14,263,71,60,5,136,51.71 %
PITTSBURGH WARD 13 DIST 15,300,99,65,6,170,56.67 %
PITTSBURGH WARD 13 DIST 16,291,76,83,13,172,59.11 %
PITTSBURGH WARD 13 DIST 17,832,234,190,3,427,51.32 %
PITTSBURGH WARD 13 DIST 18,239,73,21,2,96,40.17 %
PITTSBURGH WARD 13 DIST 19,486,147,222,3,372,76.54 %
PITTSBURGH WARD 14 DIST 1,846,149,316,4,469,55.44 %
PITTSBURGH WARD 14 DIST 2,1218,156,297,4,457,37.52 %
PITTSBURGH WARD 14 DIST 3,913,187,464,9,660,72.29 %
PITTSBURGH WARD 14 DIST 4,803,129,479,3,611,76.09 %
PITTSBURGH WARD 14 DIST 5,835,166,468,10,644,77.13 %
PITTSBURGH WARD 14 DIST 6,596,135,226,3,364,61.07 %
PITTSBURGH WARD 14 DIST 7,3533,343,469,16,828,23.44 %
PITTSBURGH WARD 14 DIST 8,830,189,377,12,578,69.64 %
PITTSBURGH WARD 14 DIST 9,779,170,491,6,667,85.62 %
PITTSBURGH WARD 14 DIST 10,732,156,440,4,600,81.97 %
PITTSBURGH WARD 14 DIST 11,833,192,479,4,675,81.03 %
PITTSBURGH WARD 14 DIST 12,837,182,380,7,569,67.98 %
PITTSBURGH WARD 14 DIST 13,759,162,425,12,599,78.92 %
PITTSBURGH WARD 14 DIST 14,873,179,481,11,671,76.86 %
PITTSBURGH WARD 14 DIST 15,776,156,392,5,553,71.26 %
PITTSBURGH WARD 14 DIST 16,492,111,303,1,415,84.35 %
PITTSBURGH WARD 14 DIST 17,473,112,283,7,402,84.99 %
PITTSBURGH WARD 14 DIST 18,745,157,442,8,607,81.48 %
PITTSBURGH WARD 14 DIST 19,615,143,360,3,506,82.28 %
PITTSBURGH WARD 14 DIST 20,643,113,366,10,489,76.05 %
PITTSBURGH WARD 14 DIST 21,605,161,316,4,481,79.50 %
PITTSBURGH WARD 14 DIST 22,745,156,436,9,601,80.67 %
PITTSBURGH WARD 14 DIST 23,715,138,418,5,561,78.46 %
PITTSBURGH WARD 14 DIST 24,577,100,337,6,443,76.78 %
PITTSBURGH WARD 14 DIST 25,972,196,580,12,788,81.07 %
PITTSBURGH WARD 14 DIST 26,597,151,327,4,482,80.74 %
PITTSBURGH WARD 14 DIST 27,532,198,260,3,461,86.65 %
PITTSBURGH WARD 14 DIST 28,543,231,230,4,465,85.64 %
PITTSBURGH WARD 14 DIST 29,804,198,413,5,616,76.62 %
PITTSBURGH WARD 14 DIST 30,689,148,401,2,551,79.97 %
PITTSBURGH WARD 14 DIST 31,1194,272,671,9,952,79.73 %
PITTSBURGH WARD 14 DIST 32,791,162,355,12,529,66.88 %
PITTSBURGH WARD 14 DIST 33,845,224,360,12,596,70.53 %
PITTSBURGH WARD 14 DIST 34,902,216,375,12,603,66.85 %
PITTSBURGH WARD 14 DIST 35,611,99,329,7,435,71.19 %
PITTSBURGH WARD 14 DIST 36,821,130,384,3,517,62.97 %
PITTSBURGH WARD 14 DIST 37,639,133,312,3,448,70.11 %
PITTSBURGH WARD 14 DIST 38,586,103,324,2,429,73.21 %
PITTSBURGH WARD 14 DIST 39,653,126,358,6,490,75.04 %
PITTSBURGH WARD 14 DIST 40,598,131,289,2,422,70.57 %
PITTSBURGH WARD 14 DIST 41,79,29,33,2,64,81.01 %
PITTSBURGH WARD 15 DIST 1,619,97,316,12,425,68.66 %
PITTSBURGH WARD 15 DIST 2,748,211,317,16,544,72.73 %
PITTSBURGH WARD 15 DIST 3,644,204,276,11,491,76.24 %
PITTSBURGH WARD 15 DIST 4,655,165,340,13,518,79.08 %
PITTSBURGH WARD 15 DIST 5,567,173,249,2,424,74.78 %
PITTSBURGH WARD 15 DIST 6,533,132,286,17,435,81.61 %
PITTSBURGH WARD 15 DIST 7,708,244,299,17,560,79.10 %
PITTSBURGH WARD 15 DIST 8,615,194,300,0,494,80.33 %
PITTSBURGH WARD 15 DIST 9,171,64,65,2,131,76.61 %
PITTSBURGH WARD 15 DIST 10,636,195,305,2,502,78.93 %
PITTSBURGH WARD 15 DIST 11,574,230,200,14,444,77.35 %
PITTSBURGH WARD 15 DIST 12,486,141,229,6,376,77.37 %
PITTSBURGH WARD 15 DIST 13,462,112,137,12,261,56.49 %
PITTSBURGH WARD 15 DIST 14,280,85,88,7,180,64.29 %
PITTSBURGH WARD 15 DIST 15,372,122,69,11,202,54.30 %
PITTSBURGH WARD 15 DIST 16,522,168,185,6,359,68.77 %
PITTSBURGH WARD 15 DIST 17,25,7,6,2,15,60.00 %
PITTSBURGH WARD 15 DIST 18,535,159,171,15,345,64.49 %
PITTSBURGH WARD 15 DIST 19,435,96,120,3,219,50.34 %
PITTSBURGH WARD 16 DIST 1,942,258,375,8,641,68.05 %
PITTSBURGH WARD 16 DIST 2,1266,321,490,22,833,65.80 %
PITTSBURGH WARD 16 DIST 3,952,320,329,19,668,70.17 %
PITTSBURGH WARD 16 DIST 4,432,155,128,8,291,67.36 %
PITTSBURGH WARD 16 DIST 5,635,208,255,7,470,74.02 %
PITTSBURGH WARD 16 DIST 6,526,181,186,18,385,73.19 %
PITTSBURGH WARD 16 DIST 7,410,149,111,15,275,67.07 %
PITTSBURGH WARD 16 DIST 8,171,29,21,7,57,33.33 %
PITTSBURGH WARD 16 DIST 9,479,196,133,1,330,68.89 %
PITTSBURGH WARD 16 DIST 10,382,146,123,2,271,70.94 %
PITTSBURGH WARD 16 DIST 11,416,148,117,5,270,64.90 %
PITTSBURGH WARD 17 DIST 1,264,96,83,0,179,67.80 %
PITTSBURGH WARD 17 DIST 2,881,295,272,5,572,64.93 %
PITTSBURGH WARD 17 DIST 3,606,201,229,21,451,74.42 %
PITTSBURGH WARD 17 DIST 4,813,264,324,9,597,73.43 %
PITTSBURGH WARD 17 DIST 5,623,214,213,6,433,69.50 %
PITTSBURGH WARD 17 DIST 6,444,159,119,8,286,64.41 %
PITTSBURGH WARD 17 DIST 7,400,136,147,1,284,71.00 %
PITTSBURGH WARD 17 DIST 8,439,154,152,5,311,70.84 %
PITTSBURGH WARD 18 DIST 1,575,257,198,14,469,81.57 %
PITTSBURGH WARD 18 DIST 2,414,111,126,10,247,59.66 %
PITTSBURGH WARD 18 DIST 3,365,100,127,9,236,64.66 %
PITTSBURGH WARD 18 DIST 4,435,148,112,13,273,62.76 %
PITTSBURGH WARD 18 DIST 5,950,289,398,7,694,73.05 %
PITTSBURGH WARD 18 DIST 6,376,130,95,5,230,61.17 %
PITTSBURGH WARD 18 DIST 7,469,157,153,12,322,68.66 %
PITTSBURGH WARD 18 DIST 8,266,81,70,5,156,58.65 %
PITTSBURGH WARD 18 DIST 9,687,197,181,2,380,55.31 %
PITTSBURGH WARD 18 DIST 10,65,22,22,1,45,69.23 %
PITTSBURGH WARD 18 DIST 11,566,171,161,14,346,61.13 %
PITTSBURGH WARD 19 DIST 1,543,184,254,8,446,82.14 %
PITTSBURGH WARD 19 DIST 2,712,227,265,9,501,70.37 %
PITTSBURGH WARD 19 DIST 3,563,189,231,9,429,76.20 %
PITTSBURGH WARD 19 DIST 4,411,141,173,3,317,77.13 %
PITTSBURGH WARD 19 DIST 5,465,182,169,7,358,76.99 %
PITTSBURGH WARD 19 DIST 6,553,203,226,6,435,78.66 %
PITTSBURGH WARD 19 DIST 7,225,73,77,4,154,68.44 %
PITTSBURGH WARD 19 DIST 8,576,218,181,16,415,72.05 %
PITTSBURGH WARD 19 DIST 9,570,183,201,7,391,68.60 %
PITTSBURGH WARD 19 DIST 10,696,199,244,18,461,66.24 %
PITTSBURGH WARD 19 DIST 11,523,135,176,6,317,60.61 %
PITTSBURGH WARD 19 DIST 12,429,167,204,5,376,87.65 %
PITTSBURGH WARD 19 DIST 13,491,165,147,7,319,64.97 %
PITTSBURGH WARD 19 DIST 14,565,171,212,3,386,68.32 %
PITTSBURGH WARD 19 DIST 15,639,230,227,10,467,73.08 %
PITTSBURGH WARD 19 DIST 16,604,209,238,12,459,75.99 %
PITTSBURGH WARD 19 DIST 17,553,213,214,11,438,79.20 %
PITTSBURGH WARD 19 DIST 18,456,152,146,15,313,68.64 %
PITTSBURGH WARD 19 DIST 19,532,179,203,12,394,74.06 %
PITTSBURGH WARD 19 DIST 20,514,196,210,11,417,81.13 %
PITTSBURGH WARD 19 DIST 21,673,223,255,2,480,71.32 %
PITTSBURGH WARD 19 DIST 22,558,215,222,1,438,78.49 %
PITTSBURGH WARD 19 DIST 23,592,239,200,7,446,75.34 %
PITTSBURGH WARD 19 DIST 24,475,153,202,2,357,75.16 %
PITTSBURGH WARD 19 DIST 25,540,191,244,3,438,81.11 %
PITTSBURGH WARD 19 DIST 26,481,172,181,7,360,74.84 %
PITTSBURGH WARD 19 DIST 27,474,158,178,13,349,73.63 %
PITTSBURGH WARD 19 DIST 28,627,194,352,10,556,88.68 %
PITTSBURGH WARD 19 DIST 29,499,206,196,3,405,81.16 %
PITTSBURGH WARD 19 DIST 30,532,197,240,8,445,83.65 %
PITTSBURGH WARD 19 DIST 31,491,200,194,12,406,82.69 %
PITTSBURGH WARD 19 DIST 32,535,207,215,12,434,81.12 %
PITTSBURGH WARD 19 DIST 33,465,193,176,15,384,82.58 %
PITTSBURGH WARD 19 DIST 34,540,179,241,12,432,80.00 %
PITTSBURGH WARD 19 DIST 35,545,223,189,6,418,76.70 %
PITTSBURGH WARD 19 DIST 36,682,228,297,24,549,80.50 %
PITTSBURGH WARD 19 DIST 37,449,187,173,7,367,81.74 %
PITTSBURGH WARD 19 DIST 38,575,189,230,7,426,74.09 %
PITTSBURGH WARD 20 DIST 1,614,240,241,8,489,79.64 %
PITTSBURGH WARD 20 DIST 2,234,93,80,6,179,76.50 %
PITTSBURGH WARD 20 DIST 3,700,269,285,12,566,80.86 %
PITTSBURGH WARD 20 DIST 4,70,20,23,2,45,64.29 %
PITTSBURGH WARD 20 DIST 5,571,211,200,13,424,74.26 %
PITTSBURGH WARD 20 DIST 6,540,174,152,16,342,63.33 %
PITTSBURGH WARD 20 DIST 7,694,205,182,22,409,58.93 %
PITTSBURGH WARD 20 DIST 8,711,262,216,22,500,70.32 %
PITTSBURGH WARD 20 DIST 9,205,71,59,1,131,63.90 %
PITTSBURGH WARD 20 DIST 10,643,225,152,10,387,60.19 %
PITTSBURGH WARD 20 DIST 11,705,239,136,10,385,54.61 %
PITTSBURGH WARD 20 DIST 12,927,311,312,2,625,67.42 %
PITTSBURGH WARD 20 DIST 13,437,137,169,9,315,72.08 %
PITTSBURGH WARD 20 DIST 14,875,344,251,17,612,69.94 %
PITTSBURGH WARD 20 DIST 15,934,277,353,16,646,69.16 %
PITTSBURGH WARD 20 DIST 16,640,226,289,9,524,81.88 %
PITTSBURGH WARD 20 DIST 17,436,154,200,10,364,83.49 %
PITTSBURGH WARD 20 DIST 18,489,219,185,4,408,83.44 %
PITTSBURGH WARD 21 DIST 1,463,134,133,8,275,59.40 %
PITTSBURGH WARD 21 DIST 2,455,161,154,12,327,71.87 %
PITTSBURGH WARD 21 DIST 3,654,175,273,9,457,69.88 %
PITTSBURGH WARD 21 DIST 4,584,171,245,8,424,72.60 %
PITTSBURGH WARD 22 DIST 1,732,195,335,8,538,73.50 %
PITTSBURGH WARD 22 DIST 2,673,143,355,12,510,75.78 %
PITTSBURGH WARD 22 DIST 3,696,180,310,8,498,71.55 %
PITTSBURGH WARD 22 DIST 4,892,205,304,3,512,57.40 %
PITTSBURGH WARD 23 DIST 1,1257,280,532,26,838,66.67 %
PITTSBURGH WARD 23 DIST 2,794,182,355,13,550,69.27 %
PITTSBURGH WARD 23 DIST 3,419,102,140,6,248,59.19 %
PITTSBURGH WARD 24 DIST 1,432,120,183,6,309,71.53 %
PITTSBURGH WARD 24 DIST 2,430,147,176,3,326,75.81 %
PITTSBURGH WARD 24 DIST 3,349,106,107,5,218,62.46 %
PITTSBURGH WARD 24 DIST 4,594,185,251,12,448,75.42 %
PITTSBURGH WARD 24 DIST 5,515,152,176,8,336,65.24 %
PITTSBURGH WARD 24 DIST 6,538,181,215,8,404,75.09 %
PITTSBURGH WARD 25 DIST 1,459,127,207,0,334,72.77 %
PITTSBURGH WARD 25 DIST 2,422,118,151,8,277,65.64 %
PITTSBURGH WARD 25 DIST 3,559,145,223,1,369,66.01 %
PITTSBURGH WARD 25 DIST 4,308,80,81,9,170,55.19 %
PITTSBURGH WARD 25 DIST 5,369,125,115,2,242,65.58 %
PITTSBURGH WARD 25 DIST 6,365,86,80,10,176,48.22 %
PITTSBURGH WARD 25 DIST 7,401,119,163,13,295,73.57 %
PITTSBURGH WARD 26 DIST 1,541,168,190,1,359,66.36 %
PITTSBURGH WARD 26 DIST 2,442,110,165,2,277,62.67 %
PITTSBURGH WARD 26 DIST 3,438,148,147,12,307,70.09 %
PITTSBURGH WARD 26 DIST 4,400,131,123,4,258,64.50 %
PITTSBURGH WARD 26 DIST 5,479,153,67,16,236,49.27 %
PITTSBURGH WARD 26 DIST 6,368,110,49,12,171,46.47 %
PITTSBURGH WARD 26 DIST 7,296,65,115,6,186,62.84 %
PITTSBURGH WARD 26 DIST 8,601,144,113,11,268,44.59 %
PITTSBURGH WARD 26 DIST 9,355,127,135,3,265,74.65 %
PITTSBURGH WARD 26 DIST 10,673,217,250,6,473,70.28 %
PITTSBURGH WARD 26 DIST 11,688,223,274,15,512,74.42 %
PITTSBURGH WARD 26 DIST 12,479,128,178,7,313,65.34 %
PITTSBURGH WARD 26 DIST 13,596,202,222,10,434,72.82 %
PITTSBURGH WARD 26 DIST 14,591,274,221,3,498,84.26 %
PITTSBURGH WARD 26 DIST 15,501,192,197,9,398,79.44 %
PITTSBURGH WARD 26 DIST 16,725,214,298,15,527,72.69 %
PITTSBURGH WARD 26 DIST 17,187,66,58,5,129,68.98 %
PITTSBURGH WARD 27 DIST 1,811,221,424,17,662,81.63 %
PITTSBURGH WARD 27 DIST 2,668,233,311,13,557,83.38 %
PITTSBURGH WARD 27 DIST 3,567,192,252,11,455,80.25 %
PITTSBURGH WARD 27 DIST 4,795,283,284,7,574,72.20 %
PITTSBURGH WARD 27 DIST 5,751,237,334,12,583,77.63 %
PITTSBURGH WARD 27 DIST 6,789,220,264,22,506,64.13 %
PITTSBURGH WARD 27 DIST 7,623,221,244,11,476,76.40 %
PITTSBURGH WARD 27 DIST 8,599,222,220,2,444,74.12 %
PITTSBURGH WARD 27 DIST 9,605,210,162,8,380,62.81 %
PITTSBURGH WARD 27 DIST 10,619,190,201,7,398,64.30 %
PITTSBURGH WARD 27 DIST 11,631,202,181,12,395,62.60 %
PITTSBURGH WARD 27 DIST 12,575,174,148,16,338,58.78 %
PITTSBURGH WARD 27 DIST 13,559,176,201,15,392,70.13 %
PITTSBURGH WARD 28 DIST 1,680,254,240,7,501,73.68 %
PITTSBURGH WARD 28 DIST 2,565,178,189,13,380,67.26 %
PITTSBURGH WARD 28 DIST 3,894,379,337,12,728,81.43 %
PITTSBURGH WARD 28 DIST 4,659,263,260,6,529,80.27 %
PITTSBURGH WARD 28 DIST 5,691,284,233,8,525,75.98 %
PITTSBURGH WARD 28 DIST 6,570,217,222,15,454,79.65 %
PITTSBURGH WARD 28 DIST 7,648,192,165,18,375,57.87 %
PITTSBURGH WARD 28 DIST 8,868,363,319,15,697,80.30 %
PITTSBURGH WARD 28 DIST 9,632,233,236,2,471,74.53 %
PITTSBURGH WARD 28 DIST 10,546,194,142,9,345,63.19 %
PITTSBURGH WARD 28 DIST 11,130,43,39,2,84,64.62 %
PITTSBURGH WARD 29 DIST 1,611,245,174,10,429,70.21 %
PITTSBURGH WARD 29 DIST 2,543,224,166,11,401,73.85 %
PITTSBURGH WARD 29 DIST 3,496,179,171,5,355,71.57 %
PITTSBURGH WARD 29 DIST 4,530,208,163,12,383,72.26 %
PITTSBURGH WARD 29 DIST 5,564,202,178,3,383,67.91 %
PITTSBURGH WARD 29 DIST 6,647,262,205,20,487,75.27 %
PITTSBURGH WARD 29 DIST 7,660,253,250,10,513,77.73 %
PITTSBURGH WARD 29 DIST 8,547,192,153,16,361,66.00 %
PITTSBURGH WARD 29 DIST 9,466,151,129,8,288,61.80 %
PITTSBURGH WARD 29 DIST 10,564,215,190,24,429,76.06 %
PITTSBURGH WARD 29 DIST 11,647,278,184,13,475,73.42 %
PITTSBURGH WARD 29 DIST 12,577,234,147,9,390,67.59 %
PITTSBURGH WARD 30 DIST 1,420,120,100,19,239,56.90 %
PITTSBURGH WARD 30 DIST 2,391,145,105,1,251,64.19 %
PITTSBURGH WARD 30 DIST 3,344,89,60,11,160,46.51 %
PITTSBURGH WARD 30 DIST 4,591,191,160,13,364,61.59 %
PITTSBURGH WARD 30 DIST 5,671,231,173,17,421,62.74 %
PITTSBURGH WARD 31 DIST 1,226,94,55,3,152,67.26 %
PITTSBURGH WARD 31 DIST 2,449,237,152,2,391,87.08 %
PITTSBURGH WARD 31 DIST 3,561,282,163,9,454,80.93 %
PITTSBURGH WARD 31 DIST 4,566,277,150,16,443,78.27 %
PITTSBURGH WARD 31 DIST 5,709,313,267,13,593,83.64 %
PITTSBURGH WARD 31 DIST 6,551,275,152,17,444,80.58 %
PITTSBURGH WARD 31 DIST 7,138,60,50,3,113,81.88 %
PITTSBURGH WARD 32 DIST 1,514,218,162,10,390,75.88 %
PITTSBURGH WARD 32 DIST 2,667,245,224,21,490,73.46 %
PITTSBURGH WARD 32 DIST 3,543,215,198,12,425,78.27 %
PITTSBURGH WARD 32 DIST 4,352,133,118,6,257,73.01 %
PITTSBURGH WARD 32 DIST 5,584,227,241,13,481,82.36 %
PITTSBURGH WARD 32 DIST 6,620,276,200,4,480,77.42 %
PITTSBURGH WARD 32 DIST 7,578,235,213,8,456,78.89 %
PITTSBURGH WARD 32 DIST 8,660,275,276,11,562,85.15 %
PLEASANT HL DIST 1,748,322,275,6,603,80.61 %
PLEASANT HL DIST 2,561,273,208,3,484,86.27 %
PLEASANT HL DIST 3,583,287,207,11,505,86.62 %
PLEASANT HL DIST 4,555,280,179,10,469,84.50 %
PLEASANT HL DIST 5,715,245,302,11,558,78.04 %
PLEASANT HL DIST 6,964,446,373,20,839,87.03 %
PLEASANT HL DIST 7,532,261,173,11,445,83.65 %
PLEASANT HL DIST 8,526,268,180,6,454,86.31 %
PLEASANT HL DIST 9,659,350,228,8,586,88.92 %
PLEASANT HL DIST 10,523,256,173,14,443,84.70 %
PLUM DIST 1,1828,709,784,36,1529,83.64 %
PLUM DIST 2,607,334,162,13,509,83.86 %
PLUM DIST 3,986,288,502,15,805,81.64 %
PLUM DIST 4,863,409,303,22,734,85.05 %
PLUM DIST 5,891,375,343,19,737,82.72 %
PLUM DIST 6,1264,575,496,20,1091,86.31 %
PLUM DIST 7,1261,539,509,23,1071,84.93 %
PLUM DIST 8,613,297,204,8,509,83.03 %
PLUM DIST 9,1143,466,507,24,997,87.23 %
PLUM DIST 10,611,295,202,8,505,82.65 %
PLUM DIST 11,840,380,328,7,715,85.12 %
PLUM DIST 12,1119,496,493,11,1000,89.37 %
PLUM DIST 13,582,281,215,11,507,87.11 %
PLUM DIST 14,746,335,255,3,593,79.49 %
PLUM DIST 15,853,340,271,18,629,73.74 %
PLUM DIST 16,631,290,218,10,518,82.09 %
PLUM DIST 17,720,339,223,11,573,79.58 %
PLUM DIST 18,856,397,325,9,731,85.40 %
PLUM DIST 19,2072,978,760,39,1777,85.76 %
PLUM DIST 20,979,466,338,12,816,83.35 %
PLUM DIST 21,425,233,136,4,373,87.76 %
PORT VUE DIST 1,607,292,142,11,445,73.31 %
PORT VUE DIST 2,535,283,128,6,417,77.94 %
PORT VUE DIST 3,529,270,161,7,438,82.80 %
PORT VUE DIST 4,706,374,171,14,559,79.18 %
RANKIN WARD 1,358,133,94,11,238,66.48 %
RANKIN WARD 2,401,130,93,12,235,58.60 %
RANKIN WARD 3,603,170,107,6,283,46.93 %
RESERVE WARD 1,539,275,153,7,435,80.71 %
RESERVE WARD 2,572,301,173,14,488,85.31 %
RESERVE WARD 3,542,290,175,7,472,87.08 %
RESERVE WARD 4,856,380,316,18,714,83.41 %
RICHLAND DIST 1,1142,558,414,14,986,86.34 %
RICHLAND DIST 2,1195,560,421,18,999,83.60 %
RICHLAND DIST 3,1236,619,430,21,1070,86.57 %
RICHLAND DIST 4,1159,590,405,15,1010,87.14 %
RICHLAND DIST 5,1038,504,365,16,885,85.26 %
RICHLAND DIST 6,1130,591,395,19,1005,88.94 %
RICHLAND DIST 7,1141,636,340,19,995,87.20 %
RICHLAND DIST 8,854,336,338,12,686,80.33 %
ROBINSON DIST 1,1661,624,741,23,1388,83.56 %
ROBINSON DIST 2,1165,531,452,15,998,85.67 %
ROBINSON DIST 3,706,331,248,15,594,84.14 %
ROBINSON DIST 4,827,387,295,16,698,84.40 %
ROBINSON DIST 5,616,259,250,9,518,84.09 %
ROBINSON DIST 6,874,364,297,15,676,77.35 %
ROBINSON DIST 7,1391,639,545,18,1202,86.41 %
ROBINSON DIST 8,1721,650,640,23,1313,76.29 %
ROBINSON DIST 9,2513,893,1047,35,1975,78.59 %
ROSS WARD 1 DIST 1,778,340,301,24,665,85.48 %
ROSS WARD 1 DIST 2,627,242,283,7,532,84.85 %
ROSS WARD 1 DIST 3,524,223,201,9,433,82.63 %
ROSS WARD 1 DIST 4,860,406,306,12,724,84.19 %
ROSS WARD 2 DIST 1,1227,479,510,12,1001,81.58 %
ROSS WARD 2 DIST 2,942,427,387,12,826,87.69 %
ROSS WARD 2 DIST 3,731,331,291,11,633,86.59 %
ROSS WARD 3 DIST 1,686,275,301,9,585,85.28 %
ROSS WARD 3 DIST 2,712,281,335,11,627,88.06 %
ROSS WARD 3 DIST 3,567,276,181,8,465,82.01 %
ROSS WARD 3 DIST 4,692,318,262,14,594,85.84 %
ROSS WARD 4 DIST 1,894,366,346,40,752,84.12 %
ROSS WARD 4 DIST 2,1043,455,455,21,931,89.26 %
ROSS WARD 4 DIST 3,727,316,311,13,640,88.03 %
ROSS WARD 4 DIST 4,781,339,317,10,666,85.28 %
ROSS WARD 5 DIST 1,614,277,236,17,530,86.32 %
ROSS WARD 5 DIST 2,422,177,170,4,351,83.18 %
ROSS WARD 5 DIST 3,787,271,356,11,638,81.07 %
ROSS WARD 5 DIST 4,748,299,339,19,657,87.83 %
ROSS WARD 6 DIST 1,508,216,195,6,417,82.09 %
ROSS WARD 6 DIST 2,978,345,442,12,799,81.70 %
ROSS WARD 6 DIST 3,689,309,235,11,555,80.55 %
ROSS WARD 6 DIST 4,600,272,202,11,485,80.83 %
ROSS WARD 7 DIST 1,614,274,253,6,533,86.81 %
ROSS WARD 7 DIST 2,591,252,176,6,434,73.43 %
ROSS WARD 7 DIST 3,723,332,266,21,619,85.62 %
ROSS WARD 7 DIST 4,598,258,217,11,486,81.27 %
ROSS WARD 8 DIST 1,1647,538,733,30,1301,78.99 %
ROSS WARD 8 DIST 2,516,176,205,13,394,76.36 %
ROSS WARD 8 DIST 3,564,258,228,6,492,87.23 %
ROSS WARD 9 DIST 1,832,378,346,5,729,87.62 %
ROSS WARD 9 DIST 2,969,399,414,14,827,85.35 %
ROSS WARD 9 DIST 3,785,345,310,5,660,84.08 %
ROSSLYN FARMS,407,252,98,7,357,87.71 %
SCOTT WARD 1 DIST 1,602,272,163,16,451,74.92 %
SCOTT WARD 1 DIST 2,670,312,167,12,491,73.28 %
SCOTT WARD 2 DIST 1,474,167,202,8,377,79.54 %
SCOTT WARD 2 DIST 2,669,333,234,9,576,86.10 %
SCOTT WARD 3 DIST 1,534,255,193,9,457,85.58 %
SCOTT WARD 3 DIST 2,742,276,326,14,616,83.02 %
SCOTT WARD 4 DIST 1,780,316,343,6,665,85.26 %
SCOTT WARD 4 DIST 2,652,266,293,5,564,86.50 %
SCOTT WARD 5 DIST 1,616,299,197,11,507,82.31 %
SCOTT WARD 5 DIST 2,740,316,303,16,635,85.81 %
SCOTT WARD 6 DIST 1,686,277,257,12,546,79.59 %
SCOTT WARD 6 DIST 2,820,351,319,16,686,83.66 %
SCOTT WARD 7 DIST 1,892,269,459,11,739,82.85 %
SCOTT WARD 7 DIST 2,638,286,268,3,557,87.30 %
SCOTT WARD 8 DIST 1,531,260,208,8,476,89.64 %
SCOTT WARD 8 DIST 2,1076,291,585,7,883,82.06 %
SCOTT WARD 9 DIST 1,297,102,101,2,205,69.02 %
SCOTT WARD 9 DIST 2,333,126,129,3,258,77.48 %
SEWICKLEY WARD 1,999,399,379,23,801,80.18 %
SEWICKLEY WARD 2 DIST 1,531,205,201,10,416,78.34 %
SEWICKLEY WARD 2 DIST 2,591,224,226,10,460,77.83 %
SEWICKLEY WARD 3,1047,419,394,24,837,79.94 %
SEWICKLEY HTS,792,390,228,15,633,79.92 %
SEWICKLEY HILLS,555,325,140,11,476,85.77 %
SHALER WARD 1 DIST 1,534,258,198,17,473,88.58 %
SHALER WARD 1 DIST 2,530,247,171,11,429,80.94 %
SHALER WARD 1 DIST 3,595,278,195,12,485,81.51 %
SHALER WARD 1 DIST 4,620,287,255,7,549,88.55 %
SHALER WARD 1 DIST 5,665,275,255,12,542,81.50 %
SHALER WARD 2 DIST 1,1065,512,386,14,912,85.63 %
SHALER WARD 2 DIST 2,774,386,280,15,681,87.98 %
SHALER WARD 2 DIST 3,610,302,190,10,502,82.30 %
SHALER WARD 2 DIST 4,791,416,274,10,700,88.50 %
SHALER WARD 2 DIST 5,364,174,132,0,306,84.07 %
SHALER WARD 3 DIST 1,602,266,249,6,521,86.54 %
SHALER WARD 3 DIST 2,617,276,230,9,515,83.47 %
SHALER WARD 3 DIST 3,601,277,225,12,514,85.52 %
SHALER WARD 3 DIST 4,718,330,303,7,640,89.14 %
SHALER WARD 3 DIST 5,687,311,278,12,601,87.48 %
SHALER WARD 4 DIST 1,845,435,290,10,735,86.98 %
SHALER WARD 4 DIST 2,449,205,161,12,378,84.19 %
SHALER WARD 4 DIST 3,680,330,248,12,590,86.76 %
SHALER WARD 4 DIST 4,662,295,276,1,572,86.40 %
SHALER WARD 4 DIST 5,533,237,199,6,442,82.93 %
SHALER WARD 5 DIST 1,745,397,234,10,641,86.04 %
SHALER WARD 5 DIST 2,693,334,254,5,593,85.57 %
SHALER WARD 5 DIST 3,553,268,222,6,496,89.69 %
SHALER WARD 5 DIST 4,358,156,155,5,316,88.27 %
SHALER WARD 5 DIST 5,787,363,294,11,668,84.88 %
SHALER WARD 6 DIST 1,645,297,247,8,552,85.58 %
SHALER WARD 6 DIST 2,715,329,263,14,606,84.76 %
SHALER WARD 6 DIST 3,559,281,210,2,493,88.19 %
SHALER WARD 6 DIST 4,340,171,135,6,312,91.76 %
SHALER WARD 6 DIST 5,545,224,252,1,477,87.52 %
SHALER WARD 7 DIST 1,608,278,225,15,518,85.20 %
SHALER WARD 7 DIST 2,796,374,291,1,666,83.67 %
SHALER WARD 7 DIST 3,664,302,229,10,541,81.48 %
SHALER WARD 7 DIST 4,1036,480,381,12,873,84.27 %
SHARPSBURG DIST 1,621,243,173,11,427,68.76 %
SHARPSBURG DIST 2,854,330,232,22,584,68.38 %
SHARPSBURG DIST 3,845,428,203,13,644,76.21 %
S FAYETTE DIST 1,589,279,229,8,516,87.61 %
S FAYETTE DIST 2,1143,584,371,14,969,84.78 %
S FAYETTE DIST 3,1792,941,577,18,1536,85.71 %
S FAYETTE DIST 4,874,381,322,18,721,82.49 %
S FAYETTE DIST 5,910,466,293,14,773,84.95 %
S FAYETTE DIST 6,1243,532,446,25,1003,80.69 %
S FAYETTE DIST 7,679,321,237,9,567,83.51 %
S FAYETTE DIST 8,1577,741,631,19,1391,88.21 %
S FAYETTE DIST 9,691,257,207,14,478,69.18 %
S FAYETTE DIST 10,792,364,277,22,663,83.71 %
S FAYETTE DIST 11,1066,547,312,19,878,82.36 %
S FAYETTE DIST 12,680,282,281,4,567,83.38 %
SOUTH PARK DIST 1,775,365,294,13,672,86.71 %
SOUTH PARK DIST 2,800,398,246,12,656,82.00 %
SOUTH PARK DIST 3,674,332,218,14,564,83.68 %
SOUTH PARK DIST 4,582,267,185,13,465,79.90 %
SOUTH PARK DIST 5,766,410,235,15,660,86.16 %
SOUTH PARK DIST 6,928,397,330,4,731,78.77 %
SOUTH PARK DIST 7,1115,460,463,20,943,84.57 %
SOUTH PARK DIST 8,528,251,197,11,459,86.93 %
SOUTH PARK DIST 9,839,368,304,12,684,81.53 %
SOUTH PARK DIST 10,887,460,283,18,761,85.79 %
SOUTH PARK DIST 11,585,281,173,10,464,79.32 %
SOUTH PARK DIST 12,603,292,209,15,516,85.57 %
SOUTH PARK DIST 13,1074,563,362,16,941,87.62 %
S VERSAILLES,215,149,38,4,191,88.84 %
SPRINGDAL BR DIST 1,699,331,192,14,537,76.82 %
SPRINGDAL BR DIST 2,619,342,175,9,526,84.98 %
SPRINGDAL BR DIST 3,570,282,146,11,439,77.02 %
SPRINGDAL BR DIST 4,485,235,129,8,372,76.70 %
SPRINGDALE TWP,1192,617,357,16,990,83.05 %
STOWE WARD 1,422,162,121,4,287,68.01 %
STOWE WARD 2 DIST 1,180,62,37,2,101,56.11 %
STOWE WARD 2 DIST 2,668,264,187,15,466,69.76 %
STOWE WARD 3,364,129,97,6,232,63.74 %
STOWE WARD 4 DIST 1,340,142,113,6,261,76.76 %
STOWE WARD 4 DIST 2,382,174,146,3,323,84.55 %
STOWE WARD 5,456,168,114,1,283,62.06 %
STOWE WARD 6,437,165,88,3,256,58.58 %
STOWE WARD 7,298,109,58,4,171,57.38 %
STOWE WARD 8,410,135,56,13,204,49.76 %
STOWE WARD 9,303,91,74,12,177,58.42 %
SWISSVALE DIST 1,872,277,257,25,559,64.11 %
SWISSVALE DIST 2,758,237,266,12,515,67.94 %
SWISSVALE DIST 3,662,174,250,18,442,66.77 %
SWISSVALE DIST 4,626,197,234,10,441,70.45 %
SWISSVALE DIST 5,762,221,347,12,580,76.12 %
SWISSVALE DIST 6,399,132,101,10,243,60.90 %
SWISSVALE DIST 7,694,201,328,25,554,79.83 %
SWISSVALE DIST 8,719,198,306,4,508,70.65 %
SWISSVALE DIST 9,680,206,298,5,509,74.85 %
SWISSVALE DIST 10,250,83,72,3,158,63.20 %
SWISSVALE DIST 11,696,158,416,3,577,82.90 %
TARENTUM WARD 1 DIST 1,657,361,118,1,480,73.06 %
TARENTUM WARD 1 DIST 2,476,253,115,10,378,79.41 %
TARENTUM WARD 2,562,215,137,7,359,63.88 %
TARENTUM WARD 3 DIST 1,278,143,59,1,203,73.02 %
TARENTUM WARD 3 DIST 2,592,306,99,12,417,70.44 %
THORNBURG,421,244,113,6,363,86.22 %
PENNSBURY VILL,592,301,174,11,486,82.09 %
TRAFFORD,59,38,9,1,48,81.36 %
TURTLE CREEK WARD 1 DIST 1,841,378,243,23,644,76.58 %
TURTLE CREEK WARD 1 DIST 2,432,195,100,4,299,69.21 %
TURTLE CREEK WARD 2 DIST 1,709,280,162,16,458,64.60 %
TURTLE CREEK WARD 2 DIST 2,325,138,69,13,220,67.69 %
TURTLE CREEK WARD 3 DIST 1,583,211,132,11,354,60.72 %
TURTLE CREEK WARD 3 DIST 2,479,198,142,7,347,72.44 %
UP ST CLAIR WARD 1 DIST 1,735,334,277,8,619,84.22 %
UP ST CLAIR WARD 1 DIST 2,829,358,339,10,707,85.28 %
UP ST CLAIR WARD 1 DIST 3,1127,526,469,18,1013,89.88 %
UP ST CLAIR WARD 1 DIST 4,850,355,350,7,712,83.76 %
UP ST CLAIR WARD 2 DIST 1,990,445,380,14,839,84.75 %
UP ST CLAIR WARD 2 DIST 2,723,345,247,10,602,83.26 %
UP ST CLAIR WARD 2 DIST 3,1034,433,430,12,875,84.62 %
UP ST CLAIR WARD 2 DIST 4,545,223,236,4,463,84.95 %
UP ST CLAIR WARD 3 DIST 1,1051,448,410,14,872,82.97 %
UP ST CLAIR WARD 3 DIST 2,862,430,305,11,746,86.54 %
UP ST CLAIR WARD 3 DIST 3,1182,506,462,16,984,83.25 %
UP ST CLAIR WARD 4 DIST 1,1017,485,358,11,854,83.97 %
UP ST CLAIR WARD 4 DIST 2,792,391,269,5,665,83.96 %
UP ST CLAIR WARD 4 DIST 3,622,283,217,6,506,81.35 %
UP ST CLAIR WARD 4 DIST 4,1093,352,513,15,880,80.51 %
UP ST CLAIR WARD 5 DIST 1,1332,652,462,26,1140,85.59 %
UP ST CLAIR WARD 5 DIST 2,840,420,288,14,722,85.95 %
UP ST CLAIR WARD 5 DIST 3,884,401,348,14,763,86.31 %
VERONA DIST 1,513,222,128,7,357,69.59 %
VERONA DIST 2,597,317,151,5,473,79.23 %
VERONA DIST 3,608,297,161,16,474,77.96 %
VERSAILLES DIST 1,558,272,132,11,415,74.37 %
VERSAILLES DIST 2,453,182,121,3,306,67.55 %
WALL,330,140,70,2,212,64.24 %
WEST DEER DIST 1,1452,773,478,21,1272,87.60 %
WEST DEER DIST 2,628,365,159,7,531,84.55 %
WEST DEER DIST 3,877,469,229,10,708,80.73 %
WEST DEER DIST 4,809,384,308,10,702,86.77 %
WEST DEER DIST 5,876,529,201,11,741,84.59 %
WEST DEER DIST 6,772,454,215,5,674,87.31 %
WEST DEER DIST 7,1844,742,856,16,1614,87.53 %
WEST DEER DIST 8,1546,614,700,23,1337,86.48 %
W ELIZABETH,267,168,24,3,195,73.03 %
W HOMESTEAD DIST 1,454,175,87,10,272,59.91 %
W HOMESTEAD DIST 2,459,247,136,0,383,83.44 %
W HOMESTEAD DIST 3,527,273,172,0,445,84.44 %
WEST MIFFLIN DIST 1,697,315,220,21,556,79.77 %
WEST MIFFLIN DIST 2,482,191,157,4,352,73.03 %
WEST MIFFLIN DIST 3,495,207,176,8,391,78.99 %
WEST MIFFLIN DIST 4,435,102,41,4,147,33.79 %
WEST MIFFLIN DIST 5,829,410,290,21,721,86.97 %
WEST MIFFLIN DIST 6,329,147,109,1,257,78.12 %
WEST MIFFLIN DIST 7,746,359,232,18,609,81.64 %
WEST MIFFLIN DIST 8,569,229,169,20,418,73.46 %
WEST MIFFLIN DIST 9,808,338,276,12,626,77.48 %
WEST MIFFLIN DIST 10,521,245,174,12,431,82.73 %
WEST MIFFLIN DIST 11,795,354,237,10,601,75.60 %
WEST MIFFLIN DIST 12,997,425,292,18,735,73.72 %
WEST MIFFLIN DIST 13,584,240,201,7,448,76.71 %
WEST MIFFLIN DIST 14,894,410,335,8,753,84.23 %
WEST MIFFLIN DIST 15,606,268,201,20,489,80.69 %
WEST MIFFLIN DIST 16,1202,433,586,21,1040,86.52 %
WEST MIFFLIN DIST 17,591,293,202,11,506,85.62 %
WEST MIFFLIN DIST 18,833,363,284,18,665,79.83 %
WEST MIFFLIN DIST 19,652,310,243,9,562,86.20 %
WEST MIFFLIN DIST 20,471,217,198,0,415,88.11 %
WEST MIFFLIN DIST 21,684,268,291,9,568,83.04 %
WEST VIEW DIST 1,693,341,227,7,575,82.97 %
WEST VIEW DIST 2,776,368,218,16,602,77.58 %
WEST VIEW DIST 3,604,297,169,9,475,78.64 %
WEST VIEW DIST 4,585,282,200,19,501,85.64 %
WEST VIEW DIST 5,790,350,288,14,652,82.53 %
WEST VIEW DIST 6,719,356,243,21,620,86.23 %
WEST VIEW DIST 7,650,263,276,15,554,85.23 %
WHITAKER DIST 1,433,230,86,5,321,74.13 %
WHITAKER DIST 2,360,150,92,10,252,70.00 %
WHITEHALL DIST 1,551,239,245,4,488,88.57 %
WHITEHALL DIST 2,598,292,213,5,510,85.28 %
WHITEHALL DIST 3,728,326,273,16,615,84.48 %
WHITEHALL DIST 4,670,315,254,12,581,86.72 %
WHITEHALL DIST 5,720,268,300,21,589,81.81 %
WHITEHALL DIST 6,1125,278,324,9,611,54.31 %
WHITEHALL DIST 7,451,183,168,13,364,80.71 %
WHITEHALL DIST 8,790,372,317,11,700,88.61 %
WHITEHALL DIST 9,572,253,243,7,503,87.94 %
WHITEHALL DIST 10,638,295,235,11,541,84.80 %
WHITEHALL DIST 11,637,338,203,9,550,86.34 %
WHITEHALL DIST 12,589,276,218,15,509,86.42 %
WHITEHALL DIST 13,497,212,215,9,436,87.73 %
WHITEHALL DIST 14,585,252,241,11,504,86.15 %
WHITEHALL DIST 15,997,348,502,10,860,86.26 %
WHITEHALL DIST 16,619,272,253,8,533,86.11 %
WHITE OAK DIST 1,774,345,222,34,601,77.65 %
WHITE OAK DIST 2,787,349,254,18,621,78.91 %
WHITE OAK DIST 3,904,432,310,13,755,83.52 %
WHITE OAK DIST 4,736,325,293,6,624,84.78 %
WHITE OAK DIST 5,827,409,266,11,686,82.95 %
WHITE OAK DIST 6,749,363,250,7,620,82.78 %
WHITE OAK DIST 7,1122,509,386,25,920,82.00 %
WILKINS WARD 1 DIST 1,786,312,258,19,589,74.94 %
WILKINS WARD 1 DIST 2,653,293,243,15,551,84.38 %
WILKINS WARD 1 DIST 3,854,319,374,8,701,82.08 %
WILKINS WARD 1 DIST 4,679,297,270,9,576,84.83 %
WILKINS WARD 1 DIST 5,479,139,202,9,350,73.07 %
WILKINS WARD 2 DIST 1,651,276,264,13,553,84.95 %
WILKINS WARD 2 DIST 2,949,366,341,16,723,76.19 %
WILKINSBURG WARD 1 DIST 1,975,216,352,27,595,61.03 %
WILKINSBURG WARD 1 DIST 2,731,219,200,3,422,57.73 %
WILKINSBURG WARD 1 DIST 3,457,126,122,4,252,55.14 %
WILKINSBURG WARD 1 DIST 4,606,123,306,21,450,74.26 %
WILKINSBURG WARD 1 DIST 5,553,144,272,0,416,75.23 %
WILKINSBURG WARD 1 DIST 6,975,189,406,15,610,62.56 %
WILKINSBURG WARD 2 DIST 1,786,170,280,35,485,61.70 %
WILKINSBURG WARD 2 DIST 2,969,243,466,20,729,75.23 %
WILKINSBURG WARD 2 DIST 3,795,231,212,4,447,56.23 %
WILKINSBURG WARD 2 DIST 4,537,133,118,7,258,48.04 %
WILKINSBURG WARD 2 DIST 5,797,166,276,3,445,55.83 %
WILKINSBURG WARD 3 DIST 1,758,212,388,2,602,79.42 %
WILKINSBURG WARD 3 DIST 2,658,151,310,8,469,71.28 %
WILKINSBURG WARD 3 DIST 3,811,195,221,15,431,53.14 %
WILKINSBURG WARD 3 DIST 4,1052,216,479,16,711,67.59 %
WILKINSBURG WARD 3 DIST 5,1039,231,398,7,636,61.21 %
WILKINSBURG WARD 3 DIST 6,545,129,125,16,270,49.54 %
WILMERDING DIST 1,487,173,83,8,264,54.21 %
WILMERDING DIST 2,689,284,144,7,435,63.13 %
Total:,942851,347578,364708,14434,726720,77.08 %